LOGIN,SYMBOL,TICKET,PROFIT,loss,win,win_rate
1162,EURGBP,1,-47.29,1,0,0.0
1162,EURUSD,82,-697.0,27,55,0.6707317073170732
1162,GBPJPY,3,49.46,0,3,1.0
1162,GBPUSD,43,-346.0,8,35,0.813953488372093
1162,USDCHF,2,8.92,0,2,1.0
1162,USDJPY,13,-238.97000000000003,4,9,0.6923076923076923
1396,AUDCAD,13,205.97,1,12,0.9230769230769231
1396,AUDJPY,1,-39.57,1,0,0.0
1396,AUDUSD,10,530.0,3,7,0.7
1396,EURGBP,3,33.01,0,3,1.0
1396,EURJPY,15,-294.31,5,10,0.6666666666666666
1396,EURUSD,257,-5559.93,58,199,0.77431906614786
1396,GBPCHF,1,13.84,0,1,1.0
1396,GBPJPY,8,38.83000000000001,3,5,0.625
1396,GBPUSD,25,-935.0,6,19,0.76
1396,NZDUSD,2,420.0,0,2,1.0
1396,USDCAD,1562,6004.540000000004,303,1259,0.8060179257362355
1396,USDCHF,17,379.97999999999996,3,14,0.8235294117647058
1396,USDJPY,38,-470.18,13,25,0.6578947368421053
1524,EURJPY,9,3616.96,0,9,1.0
1524,EURUSD,26,-24810.0,3,23,0.8846153846153846
1524,GBPJPY,48,-145814.50999999998,4,44,0.9166666666666666
1524,GBPUSD,41,-15850.0,1,40,0.975609756097561
1524,USDCAD,42,-16578.62,3,39,0.9285714285714286
1524,USDJPY,20,14296.35,0,20,1.0
22002,EURUSD,162,-1042.98,83,79,0.4876543209876543
22002,GBPUSD,28,-55.699999999999996,16,12,0.42857142857142855
22002,USDCHF,12,-66.78,6,6,0.5
22002,USDJPY,13,15.110000000000005,3,10,0.7692307692307693
22093,EURUSD,141,-352.0,106,35,0.24822695035460993
22093,GBPUSD,10,-500.0,8,2,0.2
31306,AUDUSD,17,365.0,10,7,0.4117647058823529
31306,EURGBP,2,-36.42,1,1,0.5
31306,EURJPY,1,-16.09,1,0,0.0
31306,EURUSD,792,-18980.3,404,388,0.4898989898989899
31306,GBPCHF,2,31.049999999999997,1,1,0.5
31306,GBPJPY,6,48.20999999999999,2,4,0.6666666666666666
31306,GBPUSD,181,-1891.0,102,79,0.43646408839779005
31306,USDCAD,9,-518.68,7,2,0.2222222222222222
31306,USDCHF,46,-16.449999999999992,14,32,0.6956521739130435
31306,USDJPY,41,-564.0,15,26,0.6341463414634146
43044,AUDJPY,1,0.65,0,1,1.0
43044,EURCHF,1,1.5,0,1,1.0
43044,EURGBP,2,-4.0,1,1,0.5
43044,EURJPY,1,-4.79,1,0,0.0
43044,EURUSD,798,-830.9,285,513,0.6428571428571429
43044,GBPUSD,2,3.3,0,2,1.0
43044,USDCHF,1,-3.94,1,0,0.0
43044,USDJPY,1,-3.04,1,0,0.0
51023,AUDUSD,17,-5.5,11,6,0.35294117647058826
51023,EURGBP,7,-80.03,4,3,0.42857142857142855
51023,EURJPY,1,-19.1,1,0,0.0
51023,EURUSD,8402,-22384.99,5062,3340,0.3975243989526303
51023,GBPJPY,6,-2.0299999999999994,2,4,0.6666666666666666
51023,GBPUSD,688,-2702.2,435,253,0.36773255813953487
51023,NZDUSD,5,-9.4,4,1,0.2
51023,USDCAD,11,0.9700000000000006,8,3,0.2727272727272727
51023,USDCHF,5,-23.85,4,1,0.2
51023,USDJPY,41,267.09,23,18,0.43902439024390244
51023,XAUUSD,1,-0.65,1,0,0.0
51040,AUDJPY,13,-921.55,4,9,0.6923076923076923
51040,AUDNZD,60,-1258.92,13,47,0.7833333333333333
51040,AUDUSD,1,-10.0,1,0,0.0
51040,EURCHF,3,155.04,0,3,1.0
51040,EURJPY,214,-361.1199999999997,46,168,0.7850467289719626
51040,EURUSD,103,-1454.0,20,83,0.8058252427184466
51040,GBPJPY,446,-18733.72,92,354,0.7937219730941704
51040,GBPUSD,569,-19374.0,94,475,0.8347978910369068
51040,NZDUSD,1,10.0,0,1,1.0
51040,USDCAD,395,-12289.99,84,311,0.7873417721518987
51040,USDCHF,1,-1.66,1,0,0.0
51040,USDJPY,108,2066.02,18,90,0.8333333333333334
51040,USDMXN,1,-3.28,1,0,0.0
51114,EURUSD,67,57.900000000000006,45,22,0.3283582089552239
51114,GBPJPY,5,-183.47,5,0,0.0
51114,GBPUSD,34,-636.0,29,5,0.14705882352941177
51114,USDCHF,13,-93.58,11,2,0.15384615384615385
51166,AUDUSD,10,333.0,1,9,0.9
51166,EURCAD,2,65.01,0,2,1.0
51166,EURCHF,1,-175.13,1,0,0.0
51166,EURJPY,33,-3534.04,12,21,0.6363636363636364
51166,EURUSD,187,-11431.4,65,122,0.6524064171122995
51166,GBPJPY,34,-3344.84,14,20,0.5882352941176471
51166,GBPUSD,189,230.0,56,133,0.7037037037037037
51166,NZDUSD,1,-26.0,1,0,0.0
51166,USDCAD,23,-2485.96,9,14,0.6086956521739131
51166,USDCHF,21,-855.6800000000001,11,10,0.47619047619047616
51166,USDJPY,43,-212.09000000000006,17,26,0.6046511627906976
51183,AUDCAD,1,2.97,0,1,1.0
51183,AUDUSD,2,50.0,0,2,1.0
51183,CHFJPY,2,-6.980000000000002,1,1,0.5
51183,EURCHF,22,99.28000000000002,7,15,0.6818181818181818
51183,EURGBP,5,168.74,1,4,0.8
51183,EURJPY,37,-521.67,14,23,0.6216216216216216
51183,EURUSD,155,-777.0,55,100,0.6451612903225806
51183,GBPCHF,3,150.59,0,3,1.0
51183,GBPJPY,15,-164.24,5,10,0.6666666666666666
51183,GBPUSD,374,-1686.2,97,277,0.7406417112299465
51183,NZDUSD,1,50.0,0,1,1.0
51183,USDCAD,2,0.44000000000000483,1,1,0.5
51183,USDCHF,81,434.98,23,58,0.7160493827160493
51183,USDJPY,30,71.95000000000002,7,23,0.7666666666666667
51252,AUDCAD,1,33.77,0,1,1.0
51252,AUDJPY,7,31.490000000000002,3,4,0.5714285714285714
51252,AUDNZD,2,-364.14,1,1,0.5
51252,AUDUSD,19,20.0,10,9,0.47368421052631576
51252,CADJPY,2,44.04,0,2,1.0
51252,EURAUD,1,51.35,0,1,1.0
51252,EURGBP,18,270.04,11,7,0.3888888888888889
51252,EURJPY,8,-128.03,4,4,0.5
51252,EURUSD,287,-754.09,148,139,0.4843205574912892
51252,GBPCHF,6,287.8900000000001,4,2,0.3333333333333333
51252,GBPJPY,70,-207.26,30,40,0.5714285714285714
51252,GBPUSD,153,-2626.0,84,69,0.45098039215686275
51252,NZDUSD,4,-368.0,2,2,0.5
51252,USDCAD,15,-86.69,7,8,0.5333333333333333
51252,USDCHF,11,13.98999999999998,6,5,0.45454545454545453
51252,USDJPY,15,-102.2,10,5,0.3333333333333333
51252,USDMXN,2,-54.07,2,0,0.0
51252,XAGUSD,2,-83.0,2,0,0.0
51252,XAUUSD,13,-273.0,11,2,0.15384615384615385
51303,AUDUSD,33,154.01000000000002,14,19,0.5757575757575758
51303,EURCHF,14,102.91,7,7,0.5
51303,EURGBP,2,-78.67,2,0,0.0
51303,EURJPY,1,-11.8,1,0,0.0
51303,EURUSD,67,-81.26000000000002,43,24,0.3582089552238806
51303,GBPCHF,15,-100.23000000000005,8,7,0.4666666666666667
51303,GBPJPY,1,-56.03,1,0,0.0
51303,GBPUSD,43,-653.67,26,17,0.3953488372093023
51303,NZDUSD,14,-484.85,10,4,0.2857142857142857
51303,USDCAD,15,-90.65,11,4,0.26666666666666666
51303,USDCHF,1,8.05,0,1,1.0
51353,EURGBP,1,-14.93,1,0,0.0
51353,EURUSD,219,-1258.1,78,141,0.6438356164383562
51353,GBPUSD,1,-41.0,1,0,0.0
51353,USDCHF,3,-23.97,2,1,0.3333333333333333
51353,USDJPY,12,-20.080000000000005,4,8,0.6666666666666666
51353,XAGUSD,9,-131.0,5,4,0.4444444444444444
51564,AUDCAD,2,-263.96999999999997,1,1,0.5
51564,AUDUSD,16,235.11,6,10,0.625
51564,CHFJPY,6,134.79999999999998,3,3,0.5
51564,EURAUD,1,258.63,0,1,1.0
51564,EURCAD,5,396.90999999999997,0,5,1.0
51564,EURCHF,26,2348.15,7,19,0.7307692307692307
51564,EURGBP,19,1264.25,5,14,0.7368421052631579
51564,EURJPY,6,57.62,2,4,0.6666666666666666
51564,EURUSD,56,1221.1,23,33,0.5892857142857143
51564,GBPCHF,28,-6109.509999999999,5,23,0.8214285714285714
51564,GBPJPY,5,17746.62,0,5,1.0
51564,GBPUSD,18,-1033.0,9,9,0.5
51564,NZDUSD,1,30.0,0,1,1.0
51564,USDCAD,6,39.47,4,2,0.3333333333333333
51564,USDCHF,16,500.82,7,9,0.5625
51564,USDJPY,3,0.64,1,2,0.6666666666666666
51571,EURCHF,8,-413.38,5,3,0.375
51571,EURUSD,3,-1868.0,2,1,0.3333333333333333
51571,GBPCHF,28,65813.52,11,17,0.6071428571428571
51571,GBPJPY,29,-38582.83,15,14,0.4827586206896552
51571,GBPUSD,51,-49562.0,32,19,0.37254901960784315
51571,USDCHF,31,-2918.3999999999996,20,11,0.3548387096774194
51571,USDJPY,3,-28256.9,3,0,0.0
51754,AUDJPY,3,-54.75,2,1,0.3333333333333333
51754,AUDUSD,4,280.0,0,4,1.0
51754,EURGBP,3,-125.62,1,2,0.6666666666666666
51754,EURJPY,4,-71.37000000000008,3,1,0.25
51754,EURUSD,51,235.0,22,29,0.5686274509803921
51754,GBPCHF,2,177.69,1,1,0.5
51754,GBPJPY,20,-990.6499999999999,8,12,0.6
51754,GBPUSD,76,188.0,34,42,0.5526315789473685
51754,USDCHF,26,-7737.68,16,10,0.38461538461538464
51754,USDJPY,22,-58.52000000000018,9,13,0.5909090909090909
51765,AUDCAD,2,-756.08,1,1,0.5
51765,AUDJPY,7,29.62,0,7,1.0
51765,AUDNZD,1,-444.34,1,0,0.0
51765,AUDUSD,3,-610.0,2,1,0.3333333333333333
51765,CADJPY,1,293.62,0,1,1.0
51765,EURAUD,2,21.669999999999998,0,2,1.0
51765,EURCAD,3,-105.99000000000001,1,2,0.6666666666666666
51765,EURCHF,9,-77.0,1,8,0.8888888888888888
51765,EURGBP,49,202.62000000000003,2,47,0.9591836734693877
51765,EURJPY,289,2768.42,19,270,0.9342560553633218
51765,EURUSD,493,277.0,130,363,0.7363083164300203
51765,GBPCHF,422,-15688.4,44,378,0.8957345971563981
51765,GBPJPY,756,-6147.000000000001,68,688,0.91005291005291
51765,GBPUSD,272,-15215.0,58,214,0.7867647058823529
51765,NZDUSD,17,87.0,4,13,0.7647058823529411
51765,USDCAD,48,-1602.5900000000001,14,34,0.7083333333333334
51765,USDCHF,306,208.35000000000002,31,275,0.8986928104575164
51765,USDJPY,423,-7135.32,58,365,0.8628841607565012
51787,AUDCAD,1,-16.65,1,0,0.0
51787,AUDUSD,5,-76.0,3,2,0.4
51787,EURJPY,58,-679.47,32,26,0.4482758620689655
51787,EURUSD,33,-1807.0,28,5,0.15151515151515152
51787,GBPJPY,298,-12587.64,157,141,0.47315436241610737
51787,GBPUSD,118,-3452.0,61,57,0.4830508474576271
51787,USDCAD,3,-34.949999999999996,1,2,0.6666666666666666
51787,USDJPY,46,-765.44,28,18,0.391304347826087
51877,AUDCAD,19,-1113.44,8,11,0.5789473684210527
51877,AUDJPY,470,-20322.04,165,305,0.648936170212766
51877,AUDNZD,18,17.25999999999999,5,13,0.7222222222222222
51877,AUDUSD,564,-41866.56,241,323,0.5726950354609929
51877,CADJPY,123,-2777.19,61,62,0.5040650406504065
51877,CHFJPY,63,132.9799999999999,23,40,0.6349206349206349
51877,EURAUD,345,-12784.63,162,183,0.5304347826086957
51877,EURCAD,22,215.46000000000004,7,15,0.6818181818181818
51877,EURCHF,374,1035.9399999999998,117,257,0.6871657754010695
51877,EURGBP,338,2952.8900000000003,114,224,0.6627218934911243
51877,EURJPY,768,11392.5,267,501,0.65234375
51877,EURUSD,828,5532.9400000000005,265,563,0.6799516908212561
51877,GBPCHF,467,6307.88,125,342,0.7323340471092077
51877,GBPJPY,710,-14415.320000000002,226,484,0.6816901408450704
51877,GBPUSD,739,-1520.52,293,446,0.6035182679296346
51877,NZDUSD,434,-15438.779999999999,188,246,0.5668202764976958
51877,USDCAD,532,-11593.449999999999,258,274,0.5150375939849624
51877,USDCHF,610,-7038.449999999999,240,370,0.6065573770491803
51877,USDJPY,658,-5174.39,236,422,0.6413373860182371
51877,XAGUSD,8,-3153.0,3,5,0.625
51877,XAUUSD,397,10118.65,148,249,0.6272040302267002
51882,AUDCAD,1,-17.27,1,0,0.0
51882,AUDJPY,1,-22.61,1,0,0.0
51882,AUDNZD,1,-12.16,1,0,0.0
51882,AUDUSD,1,1.0,0,1,1.0
51882,EURAUD,2,10.21,0,2,1.0
51882,EURCHF,4,11.86,2,2,0.5
51882,EURGBP,6,-4.390000000000001,3,3,0.5
51882,EURJPY,14,25.820000000000004,7,7,0.5
51882,EURUSD,56,-14.600000000000001,35,21,0.375
51882,GBPJPY,17,-24.11,7,10,0.5882352941176471
51882,GBPUSD,64,-122.3,35,29,0.453125
51882,NZDUSD,1,-22.5,1,0,0.0
51882,USDCAD,2,-4.34,2,0,0.0
51882,USDCHF,12,23.69,4,8,0.6666666666666666
51882,USDJPY,26,-8.86,16,10,0.38461538461538464
53050,AUDUSD,6,-113.8,3,3,0.5
53050,CHFJPY,5,40.08,2,3,0.6
53050,EURCHF,5,-176.03,2,3,0.6
53050,EURGBP,5,-134.45999999999998,3,2,0.4
53050,EURJPY,152,632.52,80,72,0.47368421052631576
53050,EURUSD,56,-397.5,43,13,0.23214285714285715
53050,GBPUSD,38,-836.3,24,14,0.3684210526315789
53050,NZDUSD,6,286.1,1,5,0.8333333333333334
53050,USDCAD,4,-147.6,4,0,0.0
53050,USDCHF,40,50.48999999999999,33,7,0.175
53050,USDJPY,5,106.72999999999999,2,3,0.6
53067,EURJPY,22,-205.73,14,8,0.36363636363636365
53067,EURUSD,348,-1570.92,194,154,0.4425287356321839
53067,GBPUSD,7,-274.6,5,2,0.2857142857142857
53067,USDCAD,59,-73.55999999999999,34,25,0.423728813559322
53067,USDJPY,6,11.18,4,2,0.3333333333333333
53067,USDMXN,5,-48.870000000000005,3,2,0.4
53067,XAGUSD,1,-6.3,1,0,0.0
53067,XAUUSD,2,-4.0,1,1,0.5
53078,AUDJPY,1,-8.05,1,0,0.0
53078,EURUSD,295,-1931.0,117,178,0.6033898305084746
53078,GBPUSD,33,-430.0,18,15,0.45454545454545453
53078,USDCHF,65,-5.4499999999999975,32,33,0.5076923076923077
53078,USDJPY,28,29.630000000000003,11,17,0.6071428571428571
53078,XAUUSD,1,-12.0,1,0,0.0
53170,AUDJPY,63,22.57,42,21,0.3333333333333333
53170,AUDUSD,48,-27.1,32,16,0.3333333333333333
53170,EURCHF,9,-5.68,7,2,0.2222222222222222
53170,EURGBP,1,-3.16,1,0,0.0
53170,EURJPY,379,-309.99,273,106,0.2796833773087071
53170,EURUSD,520,-633.5,397,123,0.23653846153846153
53170,GBPJPY,111,-287.83,85,26,0.23423423423423423
53170,GBPUSD,978,-2441.1,754,224,0.22903885480572597
53170,NZDUSD,35,-186.7,20,15,0.42857142857142855
53170,USDCAD,3,5.33,1,2,0.6666666666666666
53170,USDCHF,16,-42.04,13,3,0.1875
53170,USDJPY,207,-91.35999999999999,149,58,0.28019323671497587
53234,AUDUSD,1,2.0,0,1,1.0
53234,EURCHF,6,-75.95,3,3,0.5
53234,EURJPY,5,77.94,0,5,1.0
53234,EURUSD,18,-649.0,6,12,0.6666666666666666
53234,GBPJPY,1,10.09,0,1,1.0
53234,GBPUSD,67,-1059.0,22,45,0.6716417910447762
53234,NZDUSD,1,4.0,0,1,1.0
53234,USDCAD,11,141.24,3,8,0.7272727272727273
53234,USDCHF,2,-62.370000000000005,2,0,0.0
53234,USDJPY,9,-193.2,4,5,0.5555555555555556
53261,AUDJPY,1,0.84,0,1,1.0
53261,AUDUSD,10,-226.2,7,3,0.3
53261,EURAUD,4,14.43,0,4,1.0
53261,EURCHF,3,3.34,0,3,1.0
53261,EURGBP,5,-294.81,1,4,0.8
53261,EURJPY,45,153.98,5,40,0.8888888888888888
53261,EURUSD,177,-682.8000000000001,87,90,0.5084745762711864
53261,GBPCHF,211,-1337.18,18,193,0.9146919431279621
53261,GBPJPY,63,118.47,8,55,0.873015873015873
53261,GBPUSD,200,-2150.4,69,131,0.655
53261,NZDUSD,3,-28.0,3,0,0.0
53261,USDCAD,83,53.72999999999999,10,73,0.8795180722891566
53261,USDCHF,58,59.54,4,54,0.9310344827586207
53261,USDJPY,151,-509.48,26,125,0.8278145695364238
53262,AUDJPY,1,5.83,0,1,1.0
53262,EURAUD,3,12.469999999999999,0,3,1.0
53262,EURCAD,11,39.02,0,11,1.0
53262,EURGBP,4,8.219999999999999,0,4,1.0
53262,EURJPY,100,7.969999999999999,11,89,0.89
53262,EURUSD,257,174.3,104,153,0.5953307392996109
53262,GBPCHF,138,-735.6,34,104,0.7536231884057971
53262,GBPJPY,298,-1074.84,64,234,0.785234899328859
53262,GBPUSD,3,6.7,1,2,0.6666666666666666
53262,USDCAD,2,3.73,0,2,1.0
53262,USDCHF,53,-31.260000000000012,12,41,0.7735849056603774
53262,USDJPY,47,-172.94,15,32,0.6808510638297872
53342,EURJPY,27,-686.8799999999999,15,12,0.4444444444444444
53342,EURUSD,497,-14104.25,296,201,0.4044265593561368
53342,GBPJPY,3,38.34,1,2,0.6666666666666666
53342,GBPUSD,63,-162.0,34,29,0.4603174603174603
53342,USDCAD,23,-1611.28,18,5,0.21739130434782608
53342,USDCHF,15,-1534.76,7,8,0.5333333333333333
53342,USDJPY,138,-10615.050000000001,93,45,0.32608695652173914
53342,USDMXN,161,-10252.09,105,56,0.34782608695652173
53342,XAGUSD,3,-67.0,3,0,0.0
53342,XAUUSD,9,-2614.25,8,1,0.1111111111111111
53398,AUDUSD,477,559.87,145,332,0.6960167714884696
53398,CHFJPY,3,-50.42,2,1,0.3333333333333333
53398,EURAUD,7,8.379999999999995,3,4,0.5714285714285714
53398,EURCHF,13,-104.81000000000002,5,8,0.6153846153846154
53398,EURGBP,19,35.940000000000005,6,13,0.6842105263157895
53398,EURJPY,11,36.410000000000004,3,8,0.7272727272727273
53398,EURUSD,1025,-10979.77,394,631,0.615609756097561
53398,GBPJPY,2,-104.72999999999999,2,0,0.0
53398,GBPUSD,1742,2761.94,679,1063,0.6102181400688863
53398,NZDUSD,6,-420.0,5,1,0.16666666666666666
53398,USDCAD,334,-232.24999999999994,84,250,0.7485029940119761
53398,USDCHF,171,261.84,51,120,0.7017543859649122
53398,USDJPY,211,676.69,52,159,0.7535545023696683
53573,AUDCAD,5,-1621.6000000000001,3,2,0.4
53573,AUDJPY,135,-907.3300000000002,67,68,0.5037037037037037
53573,AUDUSD,448,-2852.8,221,227,0.5066964285714286
53573,CADJPY,3,64.05,1,2,0.6666666666666666
53573,CHFJPY,21,-3878.5199999999995,13,8,0.38095238095238093
53573,EURAUD,216,-7982.280000000001,111,105,0.4861111111111111
53573,EURCAD,4,-69.32000000000001,2,2,0.5
53573,EURCHF,17,528.4999999999999,9,8,0.47058823529411764
53573,EURGBP,18,-1043.63,12,6,0.3333333333333333
53573,EURJPY,25,886.59,10,15,0.6
53573,EURUSD,576,-8616.5,276,300,0.5208333333333334
53573,GBPCHF,10,-530.32,6,4,0.4
53573,GBPJPY,49,-3731.5299999999997,30,19,0.3877551020408163
53573,GBPUSD,74,631.65,34,40,0.5405405405405406
53573,USDCAD,15,349.07,7,8,0.5333333333333333
53573,USDCHF,151,-1511.9799999999998,77,74,0.4900662251655629
53573,USDJPY,84,58.43999999999998,40,44,0.5238095238095238
53573,XAGUSD,13,-2358.0,7,6,0.46153846153846156
53573,XAUUSD,282,5409.73,148,134,0.475177304964539
53590,AUDCAD,1,-23.0,1,0,0.0
53590,AUDJPY,3,0.5999999999999988,2,1,0.3333333333333333
53590,AUDNZD,24,545.9399999999999,13,11,0.4583333333333333
53590,AUDUSD,33,-141.13,11,22,0.6666666666666666
53590,CADJPY,5,-67.0,4,1,0.2
53590,CHFJPY,10,87.66999999999999,6,4,0.4
53590,EURAUD,37,-2045.6000000000001,17,20,0.5405405405405406
53590,EURCAD,3,-111.17000000000002,1,2,0.6666666666666666
53590,EURCHF,6,120.33,1,5,0.8333333333333334
53590,EURGBP,9,-15.310000000000002,3,6,0.6666666666666666
53590,EURJPY,25,-920.8,14,11,0.44
53590,EURUSD,1870,-7105.56,745,1125,0.6016042780748663
53590,GBPCHF,5,-40.879999999999995,5,0,0.0
53590,GBPJPY,363,-1614.42,157,206,0.5674931129476584
53590,GBPUSD,418,-5919.44,187,231,0.5526315789473685
53590,NZDUSD,2,-15.6,2,0,0.0
53590,USDCAD,133,823.8199999999999,39,94,0.706766917293233
53590,USDCHF,140,605.92,58,82,0.5857142857142857
53590,USDJPY,276,-3043.12,139,137,0.4963768115942029
53590,XAUUSD,13,60.13,2,11,0.8461538461538461
53641,AUDNZD,1,-15.98,1,0,0.0
53641,EURCAD,1,-8.96,1,0,0.0
53641,EURUSD,79,105.8,22,57,0.7215189873417721
53641,GBPUSD,32,-121.0,7,25,0.78125
53641,USDCHF,6,17.22,1,5,0.8333333333333334
53641,USDJPY,7,39.42,2,5,0.7142857142857143
53709,AUDJPY,407,-1694.63,273,134,0.32923832923832924
53709,AUDUSD,61,-248.0,41,20,0.32786885245901637
53709,EURJPY,4,-60.85,2,2,0.5
53709,EURUSD,108,-901.37,60,48,0.4444444444444444
53709,GBPCHF,2,-21.99,1,1,0.5
53709,GBPJPY,345,-5466.86,228,117,0.3391304347826087
53709,GBPUSD,553,-1513.25,307,246,0.4448462929475588
53709,NZDUSD,14,-10.0,8,6,0.42857142857142855
53709,USDCAD,1,-6.82,1,0,0.0
53709,USDCHF,140,-381.19,91,49,0.35
53709,USDJPY,1,-9.47,1,0,0.0
53811,EURUSD,711,-252.26,264,447,0.6286919831223629
53811,GBPUSD,8,8.2,3,5,0.625
53811,USDJPY,1,-0.23,1,0,0.0
53863,AUDCAD,5,-3253.4100000000003,5,0,0.0
53863,AUDJPY,12,3143.27,4,8,0.6666666666666666
53863,AUDNZD,2,-138.74,2,0,0.0
53863,AUDUSD,14,-7762.0,10,4,0.2857142857142857
53863,CADJPY,10,-2326.02,5,5,0.5
53863,CHFJPY,5,-576.61,4,1,0.2
53863,EURAUD,13,1860.6499999999999,5,8,0.6153846153846154
53863,EURCAD,5,-10.000000000000002,1,4,0.8
53863,EURCHF,7,1502.75,4,3,0.42857142857142855
53863,EURGBP,8,150.52000000000004,4,4,0.5
53863,EURJPY,28,-9173.550000000001,12,16,0.5714285714285714
53863,EURUSD,432,19969.62,171,261,0.6041666666666666
53863,GBPCHF,7,-1961.6,4,3,0.42857142857142855
53863,GBPJPY,244,-2741.030000000001,95,149,0.610655737704918
53863,GBPUSD,56,-6930.8,25,31,0.5535714285714286
53863,NZDUSD,8,-9164.5,7,1,0.125
53863,USDCAD,19,5412.08,12,7,0.3684210526315789
53863,USDCHF,34,-2562.67,15,19,0.5588235294117647
53863,USDJPY,27,4121.2300000000005,16,11,0.4074074074074074
53902,AUDUSD,3,-15.0,2,1,0.3333333333333333
53902,EURGBP,1,195.74,0,1,1.0
53902,EURUSD,509,-5102.9,211,298,0.5854616895874263
53902,GBPUSD,366,-13594.5,178,188,0.5136612021857924
53902,USDCAD,36,-775.8000000000002,8,28,0.7777777777777778
53902,USDCHF,2,-11.63,2,0,0.0
53902,USDJPY,3,299.24,1,2,0.6666666666666666
53933,AUDJPY,12,1.7600000000000033,4,8,0.6666666666666666
53933,AUDNZD,1,-1.39,1,0,0.0
53933,AUDUSD,52,-48.74,26,26,0.5
53933,CADJPY,13,-27.78,6,7,0.5384615384615384
53933,CHFJPY,2,-21.62,1,1,0.5
53933,EURAUD,2,-0.3200000000000003,1,1,0.5
53933,EURCHF,1,19.15,0,1,1.0
53933,EURGBP,10,-26.2,7,3,0.3
53933,EURJPY,152,-582.36,79,73,0.48026315789473684
53933,EURUSD,401,-1210.67,217,184,0.45885286783042395
53933,GBPCHF,5,-40.06,2,3,0.6
53933,GBPJPY,157,-2272.24,80,77,0.49044585987261147
53933,GBPUSD,382,-2352.31,220,162,0.42408376963350786
53933,NZDUSD,33,-132.71,18,15,0.45454545454545453
53933,USDCAD,25,-151.84,19,6,0.24
53933,USDCHF,36,-261.23,22,14,0.3888888888888889
53933,USDJPY,40,-158.88,27,13,0.325
53933,XAGUSD,1,2.0,0,1,1.0
54055,AUDUSD,4,37.8,0,4,1.0
54055,EURCHF,1,1.9,0,1,1.0
54055,EURGBP,14,12.909999999999997,7,7,0.5
54055,EURJPY,2,0.41,1,1,0.5
54055,EURUSD,16,30.93,11,5,0.3125
54055,GBPJPY,17,212.47,7,10,0.5882352941176471
54055,GBPUSD,38,-164.9,17,21,0.5526315789473685
54055,USDCAD,2,-37.660000000000004,2,0,0.0
54055,USDCHF,8,-54.34,5,3,0.375
54055,USDJPY,10,69.63,4,6,0.6
54055,XAGUSD,3,-12.3,2,1,0.3333333333333333
54055,XAUUSD,7,-102.3,6,1,0.14285714285714285
54084,AUDCAD,2,-90.96000000000001,2,0,0.0
54084,AUDJPY,13,-213.85000000000002,2,11,0.8461538461538461
54084,AUDNZD,2,-21.46,2,0,0.0
54084,AUDUSD,7,-198.6,4,3,0.42857142857142855
54084,CADJPY,22,-1024.42,13,9,0.4090909090909091
54084,CHFJPY,3,19.8,1,2,0.6666666666666666
54084,EURAUD,15,-92.31,3,12,0.8
54084,EURCAD,4,-26.46,2,2,0.5
54084,EURCHF,31,-356.09000000000003,19,12,0.3870967741935484
54084,EURGBP,30,-567.45,14,16,0.5333333333333333
54084,EURJPY,191,-1264.14,124,67,0.3507853403141361
54084,EURUSD,589,-2612.5,396,193,0.32767402376910015
54084,GBPCHF,10,143.48,0,10,1.0
54084,GBPJPY,292,-4988.03,217,75,0.2568493150684932
54084,GBPUSD,278,-1409.8,186,92,0.33093525179856115
54084,NZDUSD,38,-622.0,23,15,0.39473684210526316
54084,USDCAD,72,4.969999999999984,42,30,0.4166666666666667
54084,USDCHF,29,-330.4,15,14,0.4827586206896552
54084,USDJPY,37,-51.249999999999986,16,21,0.5675675675675675
54084,XAUUSD,1,-19.0,1,0,0.0
54133,AUDNZD,1,-13.56,1,0,0.0
54133,AUDUSD,127,4213.95,23,104,0.8188976377952756
54133,EURAUD,1,7.22,0,1,1.0
54133,EURCAD,3,-95.38,1,2,0.6666666666666666
54133,EURUSD,26,-395.88,18,8,0.3076923076923077
54133,GBPUSD,82,-949.2,54,28,0.34146341463414637
54133,NZDUSD,91,3024.55,13,78,0.8571428571428571
54133,USDCAD,98,2376.04,4,94,0.9591836734693877
54133,USDCHF,14,461.76,3,11,0.7857142857142857
54133,USDJPY,81,567.15,24,57,0.7037037037037037
54133,XAGUSD,97,5601.5,1,96,0.9896907216494846
54133,XAUUSD,133,7279.81,5,128,0.9624060150375939
54134,AUDUSD,3,45.0,0,3,1.0
54134,EURGBP,1,-51.05,1,0,0.0
54134,EURJPY,4,106.17,0,4,1.0
54134,EURUSD,694,-1278.92,203,491,0.707492795389049
54134,USDJPY,7,46.620000000000005,3,4,0.5714285714285714
54332,AUDUSD,65,35.2,33,32,0.49230769230769234
54332,CHFJPY,1,0.18,0,1,1.0
54332,EURCAD,1,-3.18,1,0,0.0
54332,EURCHF,1,-0.42,1,0,0.0
54332,EURGBP,5,-15.49,4,1,0.2
54332,EURJPY,1,0.53,0,1,1.0
54332,EURUSD,1915,-1061.3999999999999,895,1020,0.5326370757180157
54332,GBPCHF,9,-62.43,4,5,0.5555555555555556
54332,GBPJPY,10,-51.31,7,3,0.3
54332,GBPUSD,1759,-2723.75,816,943,0.5361000568504832
54332,USDCAD,36,-83.16000000000001,22,14,0.3888888888888889
54332,USDCHF,51,-126.65,31,20,0.39215686274509803
54332,USDJPY,55,-122.02,31,24,0.43636363636363634
54363,AUDCAD,2,-109.18,2,0,0.0
54363,AUDJPY,4,-67.19,4,0,0.0
54363,AUDUSD,3,-103.0,3,0,0.0
54363,CHFJPY,3,-13.839999999999996,1,2,0.6666666666666666
54363,EURAUD,4,-51.839999999999996,3,1,0.25
54363,EURCHF,14,-129.93,10,4,0.2857142857142857
54363,EURGBP,5,-94.15,4,1,0.2
54363,EURJPY,204,-133.81,121,83,0.4068627450980392
54363,EURUSD,6,-182.0,4,2,0.3333333333333333
54363,GBPCHF,1,1.71,0,1,1.0
54363,GBPJPY,1,-17.38,1,0,0.0
54363,GBPUSD,33,-175.0,25,8,0.24242424242424243
54363,NZDUSD,2,-144.0,2,0,0.0
54363,USDCAD,7,129.37,6,1,0.14285714285714285
54363,USDCHF,13,-68.72,7,6,0.46153846153846156
54363,USDJPY,14,-113.16,10,4,0.2857142857142857
54399,AUDJPY,5,284.71,2,3,0.6
54399,AUDUSD,2,-180.0,2,0,0.0
54399,EURJPY,40,-14818.43,4,36,0.9
54399,EURUSD,52,6794.0,9,43,0.8269230769230769
54399,GBPCHF,7,-126.89000000000003,1,6,0.8571428571428571
54399,GBPJPY,116,6754.089999999999,14,102,0.8793103448275862
54399,GBPUSD,1434,-194549.1,330,1104,0.7698744769874477
54399,NZDUSD,1,600.0,0,1,1.0
54399,USDCAD,6,-862.21,3,3,0.5
54399,USDCHF,6,-115.58000000000001,3,3,0.5
54399,USDJPY,24,-1483.6699999999998,11,13,0.5416666666666666
54399,XAUUSD,4,302.4,0,4,1.0
54694,EURUSD,124,-437.0,90,34,0.27419354838709675
54819,AUDUSD,3,-3.5,3,0,0.0
54819,EURJPY,16,107.63000000000001,7,9,0.5625
54819,EURUSD,2365,-10843.039999999999,1008,1357,0.573784355179704
54819,GBPJPY,131,-238.06,78,53,0.40458015267175573
54819,GBPUSD,255,-768.9,154,101,0.396078431372549
54819,NZDUSD,2,1.8,1,1,0.5
54819,USDCHF,1,1.14,0,1,1.0
54819,USDJPY,44,-156.01,33,11,0.25
54819,XAGUSD,189,-274.31,107,82,0.43386243386243384
54900,AUDUSD,6,-116.0,6,0,0.0
54900,CHFJPY,1,0.95,0,1,1.0
54900,EURCHF,2,9.05,0,2,1.0
54900,EURUSD,2171,-23583.6,988,1183,0.5449101796407185
54900,GBPUSD,195,-8547.7,110,85,0.4358974358974359
54900,NZDUSD,172,-2984.0,85,87,0.5058139534883721
54900,USDCAD,3,27.549999999999997,0,3,1.0
54900,USDCHF,2,-119.61,2,0,0.0
54900,USDJPY,24,-3.9700000000000024,10,14,0.5833333333333334
54900,XAGUSD,1,-19.0,1,0,0.0
54919,EURJPY,1,-1.71,1,0,0.0
54919,EURUSD,165,-43.06999999999998,44,121,0.7333333333333333
54919,USDJPY,4,-44.86,3,1,0.25
56588,AUDUSD,30,-560.3,15,15,0.5
56588,CADJPY,1,20.87,0,1,1.0
56588,EURJPY,9,-470.88000000000005,6,3,0.3333333333333333
56588,EURUSD,67,-545.29,29,38,0.5671641791044776
56588,GBPJPY,10,23.639999999999993,5,5,0.5
56588,GBPUSD,17,-697.8,11,6,0.35294117647058826
56588,NZDUSD,1,0.0,1,0,0.0
56588,USDCAD,7,43.390000000000015,4,3,0.42857142857142855
56588,USDCHF,8,175.49,3,5,0.625
56588,USDJPY,25,105.73,13,12,0.48
56588,XAUUSD,102,-628.09,47,55,0.5392156862745098
59036,EURUSD,523,-5650.8,280,243,0.4646271510516252
59036,GBPUSD,39,-479.0,26,13,0.3333333333333333
59036,USDCHF,5,-11.480000000000002,3,2,0.4
59036,USDJPY,181,-415.71000000000004,96,85,0.4696132596685083
59036,XAUUSD,1,-4.0,1,0,0.0
59044,AUDJPY,1,31.88,0,1,1.0
59044,EURUSD,330,-1187.6,95,235,0.7121212121212122
59044,GBPJPY,3,-148.76000000000002,1,2,0.6666666666666666
59044,GBPUSD,2,260.0,0,2,1.0
59044,USDCHF,1,65.36,0,1,1.0
59395,EURUSD,424,-4439.15,126,298,0.7028301886792453
59395,GBPCHF,1,4.17,0,1,1.0
59395,GBPJPY,21,-27.94000000000017,2,19,0.9047619047619048
59395,GBPUSD,17,-308.0,4,13,0.7647058823529411
59395,USDJPY,2,16.41,0,2,1.0
59399,AUDUSD,2,-7.0,1,1,0.5
59399,EURJPY,1,2.5,0,1,1.0
59399,EURUSD,136,293.68,14,122,0.8970588235294118
59399,GBPUSD,9,-225.0,1,8,0.8888888888888888
59399,USDJPY,1,0.83,0,1,1.0
59405,AUDJPY,14,-9.72,9,5,0.35714285714285715
59405,AUDUSD,13,-0.36000000000000004,4,9,0.6923076923076923
59405,EURGBP,1,-3.32,1,0,0.0
59405,EURJPY,71,21.26,14,57,0.8028169014084507
59405,EURUSD,563,-227.40000000000006,155,408,0.7246891651865008
59405,GBPJPY,5,-9.0,2,3,0.6
59405,GBPUSD,95,11.030000000000001,24,71,0.7473684210526316
59405,NZDUSD,58,-205.0,10,48,0.8275862068965517
59405,USDCAD,3,-0.6200000000000001,1,2,0.6666666666666666
59405,USDJPY,13,-14.16,7,6,0.46153846153846156
59468,AUDJPY,9,258.87000000000006,2,7,0.7777777777777778
59468,AUDNZD,1,68.25,0,1,1.0
59468,CADJPY,3,-241.52999999999997,1,2,0.6666666666666666
59468,EURCAD,1,39.26,0,1,1.0
59468,EURJPY,8,36.879999999999995,2,6,0.75
59468,EURUSD,1,10.0,0,1,1.0
59468,GBPCHF,2,155.65,0,2,1.0
59468,GBPJPY,139,2291.199999999996,24,115,0.8273381294964028
59468,GBPUSD,5,-80.0,2,3,0.6
59468,NZDUSD,1,120.0,0,1,1.0
59468,USDJPY,4,513.45,0,4,1.0
59478,AUDUSD,5,-112.0,2,3,0.6
59478,EURCHF,1,-165.92,1,0,0.0
59478,EURJPY,7,341.58,2,5,0.7142857142857143
59478,EURUSD,171,-3202.0,75,96,0.5614035087719298
59478,GBPJPY,71,-348.56000000000006,27,44,0.6197183098591549
59478,GBPUSD,59,-1850.0,18,41,0.6949152542372882
59478,USDCAD,2,-147.45000000000002,2,0,0.0
59478,USDCHF,27,311.31,10,17,0.6296296296296297
59478,USDJPY,23,-2326.01,12,11,0.4782608695652174
59478,XAUUSD,1,-45.0,1,0,0.0
59557,AUDJPY,2,1.5,1,1,0.5
59557,AUDUSD,11,83.0,5,6,0.5454545454545454
59557,EURCHF,1,-33.09,1,0,0.0
59557,EURGBP,1,-99.72,1,0,0.0
59557,EURJPY,14,33.61999999999998,7,7,0.5
59557,EURUSD,39,124.0,19,20,0.5128205128205128
59557,GBPUSD,27,-667.0,16,11,0.4074074074074074
59557,USDCAD,9,-257.3,5,4,0.4444444444444444
59557,USDCHF,29,-298.53000000000003,15,14,0.4827586206896552
59557,USDJPY,4,-315.3,3,1,0.25
59604,AUDNZD,4,-40.18,3,1,0.25
59604,AUDUSD,2,-33.7,2,0,0.0
59604,EURCAD,1,-6.63,1,0,0.0
59604,EURCHF,2,5.739999999999999,0,2,1.0
59604,EURGBP,1,0.28,0,1,1.0
59604,EURJPY,1,-10.04,1,0,0.0
59604,EURUSD,32,-380.9,22,10,0.3125
59604,GBPJPY,1,13.19,0,1,1.0
59604,GBPUSD,34,-175.5,17,17,0.5
59604,NZDUSD,1,-3.5,1,0,0.0
59604,USDCAD,3,-12.67,1,2,0.6666666666666666
59604,USDCHF,12,-40.22,9,3,0.25
59604,USDJPY,5,-85.87,5,0,0.0
59604,USDMXN,3,-24.8,2,1,0.3333333333333333
59942,AUDCAD,1,-16.34,1,0,0.0
59942,AUDJPY,4,-38.25,3,1,0.25
59942,AUDNZD,3,-14.39,2,1,0.3333333333333333
59942,AUDUSD,49,-400.87,18,31,0.6326530612244898
59942,CHFJPY,12,59.49000000000001,3,9,0.75
59942,EURAUD,4,-10.45,3,1,0.25
59942,EURCAD,7,-14.499999999999998,2,5,0.7142857142857143
59942,EURCHF,27,161.42,10,17,0.6296296296296297
59942,EURGBP,52,-878.97,24,28,0.5384615384615384
59942,EURJPY,26,-852.11,13,13,0.5
59942,EURUSD,176,215.44,51,125,0.7102272727272727
59942,GBPJPY,9,-72.50999999999999,6,3,0.3333333333333333
59942,GBPUSD,73,-558.59,35,38,0.5205479452054794
59942,NZDUSD,10,-23.8,7,3,0.3
59942,USDCAD,107,-250.17999999999998,48,59,0.5514018691588785
59942,USDCHF,60,-648.32,27,33,0.55
59942,USDJPY,79,-119.94999999999999,35,44,0.5569620253164557
60046,EURGBP,1,-2.76,1,0,0.0
60046,EURUSD,6310,-62223.7,1194,5116,0.8107765451664025
60050,AUDUSD,72,-790.51,10,62,0.8611111111111112
60050,EURCHF,55,85.55,4,51,0.9272727272727272
60050,EURGBP,58,-176.52,8,50,0.8620689655172413
60050,EURJPY,65,-368.52000000000004,8,57,0.8769230769230769
60050,EURUSD,104,131.2,8,96,0.9230769230769231
60050,GBPCHF,22,282.3,2,20,0.9090909090909091
60050,GBPJPY,2,0.8099999999999996,1,1,0.5
60050,GBPUSD,176,-389.3,14,162,0.9204545454545454
60050,NZDUSD,47,-509.87,6,41,0.8723404255319149
60050,USDCAD,313,-2865.8599999999997,24,289,0.9233226837060703
60050,USDCHF,204,-2477.28,14,190,0.9313725490196079
60050,USDJPY,55,15.790000000000001,3,52,0.9454545454545454
60050,XAGUSD,9,12.7,0,9,1.0
60050,XAUUSD,106,-3590.5,9,97,0.9150943396226415
60104,EURUSD,27,482.0,15,12,0.4444444444444444
60104,GBPUSD,226,2625.4,114,112,0.49557522123893805
60104,USDCHF,13,171.32000000000002,6,7,0.5384615384615384
60104,USDJPY,36,-21.559999999999995,19,17,0.4722222222222222
60104,XAUUSD,2,5.2,0,2,1.0
60696,AUDUSD,2,3.0,1,1,0.5
60696,EURCHF,3,0.5499999999999989,1,2,0.6666666666666666
60696,EURGBP,3,31.619999999999997,1,2,0.6666666666666666
60696,EURJPY,5,-36.51,3,2,0.4
60696,EURUSD,13,72.0,6,7,0.5384615384615384
60696,GBPJPY,4,-72.75999999999999,3,1,0.25
60696,GBPUSD,82,-568.85,49,33,0.4024390243902439
60696,NZDUSD,4,132.0,0,4,1.0
60696,USDCAD,1,55.16,0,1,1.0
60696,USDCHF,11,-180.45,5,6,0.5454545454545454
60696,USDJPY,7,92.38000000000001,3,4,0.5714285714285714
61199,EURUSD,508,-4442.0,54,454,0.8937007874015748
61199,GBPUSD,48,-1476.0,24,24,0.5
61277,AUDJPY,2,-195.96,2,0,0.0
61277,CADJPY,5,22.53,1,4,0.8
61277,CHFJPY,3,-138.97,3,0,0.0
61277,EURCAD,2,106.19,0,2,1.0
61277,EURCHF,4,-54.34,2,2,0.5
61277,EURGBP,6,-279.64,6,0,0.0
61277,EURJPY,10,-135.29999999999998,5,5,0.5
61277,EURUSD,95,-340.0,37,58,0.6105263157894737
61277,GBPCHF,2,-198.1,2,0,0.0
61277,GBPJPY,49,-513.73,25,24,0.4897959183673469
61277,GBPUSD,129,-981.0,68,61,0.4728682170542636
61277,NZDUSD,2,232.0,0,2,1.0
61277,USDCAD,10,-17.159999999999997,4,6,0.6
61277,USDCHF,6,-40.61,4,2,0.3333333333333333
61277,USDJPY,37,-142.4,18,19,0.5135135135135135
61312,EURAUD,5,-1297.6100000000001,4,1,0.2
61312,EURJPY,165,-7026.23,93,72,0.43636363636363634
61312,EURUSD,99,-80.0,51,48,0.48484848484848486
61312,GBPUSD,2,-350.0,1,1,0.5
61312,NZDUSD,13,-1860.0,9,4,0.3076923076923077
61312,USDCAD,7,-321.78999999999996,4,3,0.42857142857142855
61312,USDJPY,1,-436.43,1,0,0.0
61332,AUDCAD,4,-6.279999999999999,1,3,0.75
61332,AUDJPY,44,127.5,19,25,0.5681818181818182
61332,AUDNZD,4,-5.48,3,1,0.25
61332,AUDUSD,31,-18.6,19,12,0.3870967741935484
61332,CADJPY,11,10.64,6,5,0.45454545454545453
61332,CHFJPY,13,37.04,6,7,0.5384615384615384
61332,EURAUD,3,-1.66,3,0,0.0
61332,EURCAD,1,-4.71,1,0,0.0
61332,EURCHF,12,-9.6,11,1,0.08333333333333333
61332,EURGBP,23,73.3,11,12,0.5217391304347826
61332,EURJPY,30,-198.43999999999997,16,14,0.4666666666666667
61332,EURUSD,269,-147.2,135,134,0.49814126394052044
61332,GBPCHF,26,-68.48,14,12,0.46153846153846156
61332,GBPJPY,498,871.27,87,411,0.8253012048192772
61332,GBPUSD,51,-38.7,23,28,0.5490196078431373
61332,NZDUSD,19,-95.39999999999999,12,7,0.3684210526315789
61332,USDCAD,51,122.12999999999998,30,21,0.4117647058823529
61332,USDCHF,8,-62.00000000000001,3,5,0.625
61332,USDJPY,43,-76.95999999999997,25,18,0.4186046511627907
61627,AUDUSD,97,-405.26,30,67,0.6907216494845361
61627,EURJPY,2,-6.77,1,1,0.5
61627,EURUSD,1102,-16907.17,303,799,0.7250453720508166
61627,GBPUSD,65,34.79999999999999,22,43,0.6615384615384615
61627,USDCAD,1,1.47,0,1,1.0
61627,USDCHF,42,5948.92,13,29,0.6904761904761905
61627,USDJPY,75,358.4,13,62,0.8266666666666667
61627,XAGUSD,34,50.500000000000014,3,31,0.9117647058823529
61627,XAUUSD,224,1762.43,37,187,0.8348214285714286
61628,AUDCAD,3,0.78,1,2,0.6666666666666666
61628,AUDJPY,2,-2.21,1,1,0.5
61628,AUDNZD,7,7.6,0,7,1.0
61628,AUDUSD,16,-48.0,10,6,0.375
61628,EURCAD,4,-5.629999999999999,2,2,0.5
61628,EURCHF,16,-367.28,8,8,0.5
61628,EURGBP,3,37.91,1,2,0.6666666666666666
61628,EURJPY,107,-543.5699999999999,25,82,0.7663551401869159
61628,EURUSD,697,-1588.05,121,576,0.8263988522238164
61628,GBPCHF,4,-9.09,2,2,0.5
61628,GBPJPY,16,-10.160000000000002,4,12,0.75
61628,GBPUSD,262,28.700000000000042,64,198,0.7557251908396947
61628,NZDUSD,1,-38.0,1,0,0.0
61628,USDCAD,44,-431.22999999999996,6,38,0.8636363636363636
61628,USDCHF,51,-1079.53,19,32,0.6274509803921569
61628,USDJPY,44,-533.76,15,29,0.6590909090909091
61691,EURUSD,17,-129.18,14,3,0.17647058823529413
61691,GBPJPY,1,33.46,0,1,1.0
61691,USDCHF,2146,-7592.5,848,1298,0.6048462255358807
61691,USDJPY,1,-17.25,1,0,0.0
62181,AUDJPY,9,-341.14,6,3,0.3333333333333333
62181,AUDUSD,17,-44.25,4,13,0.7647058823529411
62181,EURJPY,7,28.009999999999998,3,4,0.5714285714285714
62181,EURUSD,951,-2065.84,230,721,0.7581493165089379
62181,GBPJPY,4,0.2199999999999972,2,2,0.5
62181,GBPUSD,115,-1027.2,49,66,0.5739130434782609
62181,USDCAD,1,8.0,0,1,1.0
62181,USDCHF,6,0.6299999999999994,1,5,0.8333333333333334
62181,USDJPY,159,-509.65999999999997,47,112,0.7044025157232704
62197,EURUSD,54,17.0,22,32,0.5925925925925926
62197,GBPJPY,93,-721.2000000000003,41,52,0.5591397849462365
62197,GBPUSD,334,-1991.0,141,193,0.5778443113772455
62217,AUDUSD,1,7.0,0,1,1.0
62217,CHFJPY,25,121.77000000000001,5,20,0.8
62217,EURGBP,4,-475.15999999999997,2,2,0.5
62217,EURUSD,215,-5478.6,65,150,0.6976744186046512
62217,GBPCHF,1,3.96,0,1,1.0
62217,GBPJPY,370,-9273.9,143,227,0.6135135135135135
62217,GBPUSD,177,-940.4,51,126,0.711864406779661
62217,NZDUSD,1,-11.0,1,0,0.0
62217,USDCAD,6,414.24,2,4,0.6666666666666666
62217,USDCHF,33,-156.4,16,17,0.5151515151515151
62217,USDJPY,4,83.63,3,1,0.25
62217,XAGUSD,6,-134.0,4,2,0.3333333333333333
62223,AUDJPY,4,1766.1,1,3,0.75
62223,AUDNZD,3,1922.63,1,2,0.6666666666666666
62223,AUDUSD,1,59.0,0,1,1.0
62223,CADJPY,8,409.36999999999983,4,4,0.5
62223,EURAUD,1,58.75,0,1,1.0
62223,EURGBP,1,88.83,0,1,1.0
62223,EURJPY,1,78.18,0,1,1.0
62223,EURUSD,2,125.0,0,2,1.0
62223,GBPCHF,5,2281.62,1,4,0.8
62223,GBPJPY,133,1704.8000000000002,56,77,0.5789473684210527
62223,GBPUSD,34,-1765.0,16,18,0.5294117647058824
62223,USDCHF,3,924.6700000000001,1,2,0.6666666666666666
62223,USDJPY,4,-70.31,4,0,0.0
62223,USDMXN,6,-260.64,3,3,0.5
62223,XAGUSD,1,-16.0,1,0,0.0
62669,AUDUSD,86,1580.0,20,66,0.7674418604651163
62669,EURCHF,1,-6.0,1,0,0.0
62669,EURGBP,2,-18.82,2,0,0.0
62669,EURJPY,167,-3158.26,68,99,0.592814371257485
62669,EURUSD,885,-27645.0,344,541,0.6112994350282486
62669,GBPCHF,1,-51.34,1,0,0.0
62669,GBPJPY,167,914.5299999999999,71,96,0.5748502994011976
62669,GBPUSD,214,-12579.0,82,132,0.616822429906542
62669,USDCAD,25,-737.1599999999999,15,10,0.4
62669,USDCHF,55,-241.98999999999995,27,28,0.509090909090909
62669,USDJPY,332,4838.0700000000015,139,193,0.5813253012048193
62729,EURUSD,14,-23.400000000000002,10,4,0.2857142857142857
62729,GBPUSD,40,-175.7,11,29,0.725
62729,USDCHF,1,33.44,0,1,1.0
62729,USDJPY,71,-634.0200000000001,22,49,0.6901408450704225
62741,AUDJPY,10,-331.62,4,6,0.6
62741,AUDUSD,10,793.0,5,5,0.5
62741,EURCAD,1,33.45,0,1,1.0
62741,EURCHF,9,-120.59,7,2,0.2222222222222222
62741,EURGBP,16,10.730000000000047,8,8,0.5
62741,EURJPY,20,-420.72,10,10,0.5
62741,EURUSD,67,-459.47,39,28,0.417910447761194
62741,GBPCHF,1,42.12,0,1,1.0
62741,GBPJPY,46,-1226.51,29,17,0.3695652173913043
62741,GBPUSD,14,-74.28,5,9,0.6428571428571429
62741,NZDUSD,6,-85.7,4,2,0.3333333333333333
62741,USDCAD,5,-297.22,4,1,0.2
62741,USDCHF,8,-12.95,5,3,0.375
62741,USDJPY,21,-174.01,14,7,0.3333333333333333
62881,AUDUSD,56,550.35,20,36,0.6428571428571429
62881,EURGBP,20,-158.75,15,5,0.25
62881,EURJPY,594,-2913.5999999999995,303,291,0.4898989898989899
62881,EURUSD,523,-1583.1,234,289,0.5525812619502868
62881,GBPUSD,73,-1410.7,40,33,0.4520547945205479
62881,USDCAD,143,-988.9599999999998,78,65,0.45454545454545453
62881,USDCHF,11,-28.81999999999999,6,5,0.45454545454545453
62881,USDJPY,47,-149.57,22,25,0.5319148936170213
62881,XAUUSD,23,-52.790000000000006,12,11,0.4782608695652174
62954,AUDJPY,1,-111.47,1,0,0.0
62954,AUDUSD,3,190.0,1,2,0.6666666666666666
62954,CADJPY,9,-59.71000000000001,5,4,0.4444444444444444
62954,EURJPY,414,-13426.6,276,138,0.3333333333333333
62954,EURUSD,97,-1348.0,60,37,0.38144329896907214
62954,GBPJPY,32,-3901.58,19,13,0.40625
62954,GBPUSD,82,-2579.0,48,34,0.4146341463414634
62954,NZDUSD,2,-320.0,2,0,0.0
62954,USDCHF,2,119.47,0,2,1.0
62954,USDJPY,30,-1120.86,22,8,0.26666666666666666
62955,AUDCAD,17,-11.549999999999999,1,16,0.9411764705882353
62955,AUDJPY,7,-39.470000000000006,2,5,0.7142857142857143
62955,AUDNZD,9,0.06999999999999984,4,5,0.5555555555555556
62955,AUDUSD,177,76.17999999999999,62,115,0.6497175141242938
62955,CADJPY,22,-9.450000000000001,6,16,0.7272727272727273
62955,CHFJPY,47,1.21,10,37,0.7872340425531915
62955,EURAUD,48,-437.83,15,33,0.6875
62955,EURCAD,137,-721.92,36,101,0.7372262773722628
62955,EURCHF,50,-337.5,14,36,0.72
62955,EURGBP,31,-114.83000000000001,8,23,0.7419354838709677
62955,EURJPY,416,-1267.51,99,317,0.7620192307692307
62955,EURUSD,857,-2224.07,215,642,0.7491248541423571
62955,GBPCHF,99,-1335.26,30,69,0.696969696969697
62955,GBPJPY,313,-1288.59,77,236,0.7539936102236422
62955,GBPUSD,1103,-2755.31,246,857,0.7769718948322756
62955,NZDUSD,20,-163.96,6,14,0.7
62955,USDCAD,343,-791.35,101,242,0.7055393586005831
62955,USDCHF,340,-1079.76,88,252,0.7411764705882353
62955,USDJPY,134,96.76000000000002,47,87,0.6492537313432836
63025,AUDCAD,4,-613.32,2,2,0.5
63025,AUDJPY,103,14865.72,28,75,0.7281553398058253
63025,AUDNZD,4,-347.88,1,3,0.75
63025,AUDUSD,8,-399.0,3,5,0.625
63025,CADJPY,5,-2607.8700000000003,2,3,0.6
63025,CHFJPY,8,-529.39,3,5,0.625
63025,EURAUD,11,-1382.9800000000002,5,6,0.5454545454545454
63025,EURCAD,4,-228.01,3,1,0.25
63025,EURCHF,3,-32.96,2,1,0.3333333333333333
63025,EURGBP,8,225.26999999999998,0,8,1.0
63025,EURJPY,124,-15134.05,42,82,0.6612903225806451
63025,EURUSD,200,-4534.5,64,136,0.68
63025,GBPCHF,10,311.07,4,6,0.6
63025,GBPJPY,182,-15127.77,52,130,0.7142857142857143
63025,GBPUSD,138,6420.0,45,93,0.6739130434782609
63025,USDCAD,46,-47175.05,25,21,0.45652173913043476
63025,USDCHF,19,-1119.2000000000003,7,12,0.631578947368421
63025,USDJPY,37,979.5999999999996,11,26,0.7027027027027027
63025,USDMXN,2,103.32,1,1,0.5
63073,AUDCAD,3,-79.64,2,1,0.3333333333333333
63073,AUDJPY,17,661.14,6,11,0.6470588235294118
63073,AUDUSD,79,-147.26,49,30,0.379746835443038
63073,CADJPY,1,-222.59,1,0,0.0
63073,EURAUD,5,-81.36,3,2,0.4
63073,EURCHF,2,436.16,0,2,1.0
63073,EURGBP,1,31.38,0,1,1.0
63073,EURJPY,377,-2488.14,213,164,0.4350132625994695
63073,EURUSD,195,-1591.96,120,75,0.38461538461538464
63073,GBPJPY,251,-119.24000000000014,152,99,0.3944223107569721
63073,GBPUSD,872,-6568.8,517,355,0.40711009174311924
63073,NZDUSD,14,7.0,8,6,0.42857142857142855
63073,USDCAD,72,-155.48000000000002,44,28,0.3888888888888889
63073,USDCHF,49,-548.14,23,26,0.5306122448979592
63073,USDJPY,93,-348.25,48,45,0.4838709677419355
63073,XAGUSD,2,-7950.0,2,0,0.0
63073,XAUUSD,25,50417.93,6,19,0.76
63132,AUDJPY,2,-66.07000000000001,2,0,0.0
63132,AUDUSD,47,-2108.49,27,20,0.425531914893617
63132,EURCAD,6,-1662.24,4,2,0.3333333333333333
63132,EURGBP,14,-353.53000000000003,9,5,0.35714285714285715
63132,EURJPY,118,-2441.62,63,55,0.4661016949152542
63132,EURUSD,664,-10420.4,323,341,0.5135542168674698
63132,GBPCHF,3,-2092.37,2,1,0.3333333333333333
63132,GBPJPY,87,-6297.62,51,36,0.41379310344827586
63132,GBPUSD,520,-4723.5199999999995,262,258,0.49615384615384617
63132,NZDUSD,14,-302.83,7,7,0.5
63132,USDCAD,15,-64.67999999999999,7,8,0.5333333333333333
63132,USDCHF,95,-3707.48,53,42,0.4421052631578947
63132,USDJPY,85,-923.39,45,40,0.47058823529411764
63154,AUDJPY,3,86.84,0,3,1.0
63154,AUDNZD,1,-53.93,1,0,0.0
63154,AUDUSD,6,163.0,2,4,0.6666666666666666
63154,CHFJPY,2,17.570000000000004,1,1,0.5
63154,EURCHF,4,-2.4499999999999993,1,3,0.75
63154,EURGBP,1,-37.17,1,0,0.0
63154,EURJPY,1,76.27,0,1,1.0
63154,EURUSD,4,168.0,0,4,1.0
63154,GBPJPY,16,-5513.91,7,9,0.5625
63154,GBPUSD,57,165.0,13,44,0.7719298245614035
63154,NZDUSD,21,-1240.0,5,16,0.7619047619047619
63154,USDCAD,18,-2024.32,4,14,0.7777777777777778
63154,USDCHF,47,-963.42,16,31,0.6595744680851063
63154,USDJPY,1,-164.39,1,0,0.0
63264,AUDJPY,11,80.96000000000001,1,10,0.9090909090909091
63264,AUDUSD,22,46.42999999999999,4,18,0.8181818181818182
63264,EURAUD,1,-49.28,1,0,0.0
63264,EURCHF,2,11.34,1,1,0.5
63264,EURGBP,4,-79.1,4,0,0.0
63264,EURJPY,3,11.24,1,2,0.6666666666666666
63264,EURUSD,756,-2273.23,224,532,0.7037037037037037
63264,GBPCHF,8,-9.949999999999996,3,5,0.625
63264,GBPJPY,4,-21.32,2,2,0.5
63264,GBPUSD,133,55.990000000000016,36,97,0.7293233082706767
63264,USDCAD,20,-6.220000000000006,7,13,0.65
63264,USDCHF,4,7.98,1,3,0.75
63264,USDJPY,20,-356.01,7,13,0.65
63264,XAUUSD,113,-776.63,44,69,0.6106194690265486
63885,AUDCAD,1,-21.16,1,0,0.0
63885,AUDJPY,11,-180.3,6,5,0.45454545454545453
63885,AUDNZD,7,-57.879999999999995,4,3,0.42857142857142855
63885,AUDUSD,9,-329.1,9,0,0.0
63885,CADJPY,8,-321.21000000000004,6,2,0.25
63885,CHFJPY,1,-34.58,1,0,0.0
63885,EURAUD,2,-39.91,2,0,0.0
63885,EURCAD,3,88.0,1,2,0.6666666666666666
63885,EURCHF,19,-368.2,15,4,0.21052631578947367
63885,EURGBP,15,-178.71,9,6,0.4
63885,EURJPY,40,282.24,19,21,0.525
63885,EURUSD,173,-200.9,97,76,0.4393063583815029
63885,GBPCHF,14,32.60999999999998,11,3,0.21428571428571427
63885,GBPJPY,21,847.64,9,12,0.5714285714285714
63885,GBPUSD,105,-1415.7,65,40,0.38095238095238093
63885,USDCAD,11,65.69,5,6,0.5454545454545454
63885,USDCHF,27,-498.52,22,5,0.18518518518518517
63885,USDJPY,35,-267.52,22,13,0.37142857142857144
63925,AUDJPY,26,1739.49,13,13,0.5
63925,AUDNZD,8,459.0,3,5,0.625
63925,AUDUSD,3,-280.0,2,1,0.3333333333333333
63925,EURCHF,1,35.4,0,1,1.0
63925,EURUSD,181,-4442.0,118,63,0.34806629834254144
63925,GBPJPY,2,129.93,1,1,0.5
63925,GBPUSD,128,1112.0,61,67,0.5234375
63925,NZDUSD,5,-1710.0,4,1,0.2
63925,USDCAD,1,-46.84,1,0,0.0
63925,USDCHF,6,-133.07,4,2,0.3333333333333333
63925,USDJPY,19,1784.8500000000001,9,10,0.5263157894736842
63925,XAGUSD,1,-34.0,1,0,0.0
63925,XAUUSD,1,-145.0,1,0,0.0
63961,AUDJPY,1,2.45,0,1,1.0
63961,AUDUSD,10,-199.83,4,6,0.6
63961,CADJPY,1,4.08,0,1,1.0
63961,EURJPY,18,-79.92999999999999,8,10,0.5555555555555556
63961,EURUSD,339,1170.93,84,255,0.7522123893805309
63961,GBPCHF,10,337.53,1,9,0.9
63961,GBPJPY,15,90.15000000000002,5,10,0.6666666666666666
63961,GBPUSD,75,691.0,25,50,0.6666666666666666
63961,USDCAD,130,-2309.84,31,99,0.7615384615384615
63961,USDCHF,56,-2649.94,18,38,0.6785714285714286
63961,USDJPY,100,-2201.54,32,68,0.68
63961,XAGUSD,4,-53.2,1,3,0.75
63961,XAUUSD,83,-2500.9300000000003,10,73,0.8795180722891566
64017,AUDJPY,7,-1046.02,3,4,0.5714285714285714
64017,AUDUSD,32,154.63,1,31,0.96875
64017,EURUSD,16,21.4,2,14,0.875
64017,GBPJPY,358,-19082.56,63,295,0.8240223463687151
64017,GBPUSD,1,1.3,0,1,1.0
64017,USDCAD,99,-82.25,9,90,0.9090909090909091
64017,USDJPY,27,-308.09999999999997,3,24,0.8888888888888888
64144,AUDJPY,1,36.48,0,1,1.0
64144,AUDNZD,1,1.55,0,1,1.0
64144,AUDUSD,17,-1651.5,3,14,0.8235294117647058
64144,CADJPY,2,355.98,0,2,1.0
64144,EURAUD,2,-881.0400000000001,1,1,0.5
64144,EURCAD,1,57.46,0,1,1.0
64144,EURCHF,6,186.6,0,6,1.0
64144,EURGBP,2,62.21,1,1,0.5
64144,EURJPY,48,285.96000000000004,20,28,0.5833333333333334
64144,EURUSD,84,-7480.2,25,59,0.7023809523809523
64144,GBPCHF,16,-528.85,8,8,0.5
64144,GBPJPY,155,-2408.5,59,96,0.6193548387096774
64144,GBPUSD,70,1237.6,18,52,0.7428571428571429
64144,NZDUSD,1,-118.0,1,0,0.0
64144,USDCAD,1,54.63,0,1,1.0
64144,USDCHF,24,-605.5799999999999,10,14,0.5833333333333334
64144,USDJPY,54,-1288.48,19,35,0.6481481481481481
64189,AUDCAD,2,-10.619999999999997,1,1,0.5
64189,AUDJPY,52,1091.8600000000001,23,29,0.5576923076923077
64189,AUDUSD,161,-13663.0,58,103,0.639751552795031
64189,CADJPY,13,52.870000000000005,5,8,0.6153846153846154
64189,CHFJPY,33,499.37,10,23,0.696969696969697
64189,EURAUD,11,289.15999999999997,1,10,0.9090909090909091
64189,EURCAD,2,-113.86,2,0,0.0
64189,EURCHF,12,-109.62999999999998,7,5,0.4166666666666667
64189,EURGBP,32,-1043.5,16,16,0.5
64189,EURJPY,116,-291.7700000000001,43,73,0.6293103448275862
64189,EURUSD,302,-3967.6,105,197,0.652317880794702
64189,GBPCHF,17,-77.01999999999991,9,8,0.47058823529411764
64189,GBPJPY,37,-1648.84,21,16,0.43243243243243246
64189,GBPUSD,171,-392.0,57,114,0.6666666666666666
64189,NZDUSD,32,48.9,8,24,0.75
64189,USDCAD,116,-2929.04,50,66,0.5689655172413793
64189,USDCHF,101,-3488.5699999999997,40,61,0.6039603960396039
64189,USDJPY,47,14.61999999999999,16,31,0.6595744680851063
64189,XAGUSD,20,847.0,1,19,0.95
64189,XAUUSD,22,-1977.38,3,19,0.8636363636363636
64249,AUDJPY,4,12.290000000000001,2,2,0.5
64249,AUDUSD,46,-113.7,19,27,0.5869565217391305
64249,CADJPY,7,5.099999999999991,3,4,0.5714285714285714
64249,EURAUD,2,6.870000000000001,1,1,0.5
64249,EURCAD,4,13.67,0,4,1.0
64249,EURCHF,15,-17.02,9,6,0.4
64249,EURGBP,6,-3.320000000000001,4,2,0.3333333333333333
64249,EURJPY,75,-259.71000000000004,33,42,0.56
64249,EURUSD,2804,-5977.62,1286,1518,0.5413694721825963
64249,GBPCHF,10,52.58999999999999,6,4,0.4
64249,GBPJPY,19,-252.8,10,9,0.47368421052631576
64249,GBPUSD,92,-700.7,49,43,0.4673913043478261
64249,NZDUSD,7,-108.2,6,1,0.14285714285714285
64249,USDCAD,40,95.10000000000001,21,19,0.475
64249,USDCHF,73,-114.35999999999999,40,33,0.4520547945205479
64249,USDJPY,61,-399.83,39,22,0.36065573770491804
64289,AUDCAD,1,0.98,0,1,1.0
64289,AUDUSD,8,2.6,3,5,0.625
64289,CADJPY,1,1.09,0,1,1.0
64289,CHFJPY,1,-4.6,1,0,0.0
64289,EURCHF,1,-2.23,1,0,0.0
64289,EURGBP,89,-79.12,51,38,0.42696629213483145
64289,EURJPY,49,-16.58,25,24,0.4897959183673469
64289,EURUSD,77,-211.16,37,40,0.5194805194805194
64289,GBPCHF,1,-10.02,1,0,0.0
64289,GBPJPY,8,3.71,3,5,0.625
64289,GBPUSD,668,-827.04,354,314,0.47005988023952094
64289,NZDUSD,14,-11.53,9,5,0.35714285714285715
64289,USDCAD,39,-9.65,18,21,0.5384615384615384
64289,USDCHF,37,1.6700000000000017,18,19,0.5135135135135135
64289,USDJPY,17,2.000000000000001,9,8,0.47058823529411764
64326,AUDCAD,1,121.99,0,1,1.0
64326,AUDNZD,9,-129.55999999999997,3,6,0.6666666666666666
64326,AUDUSD,10,-484.3,5,5,0.5
64326,CADJPY,2,267.63,0,2,1.0
64326,EURCAD,4,23.7,0,4,1.0
64326,EURGBP,23,200.98000000000002,11,12,0.5217391304347826
64326,EURJPY,101,-371.5799999999999,46,55,0.5445544554455446
64326,EURUSD,2363,-6636.78,990,1373,0.5810410495133305
64326,GBPCHF,14,-45.74999999999999,6,8,0.5714285714285714
64326,GBPJPY,12,245.92000000000002,3,9,0.75
64326,GBPUSD,175,-710.2,69,106,0.6057142857142858
64326,USDCAD,9,-471.9499999999999,2,7,0.7777777777777778
64326,USDCHF,31,-1.789999999999992,15,16,0.5161290322580645
64326,USDJPY,46,203.9700000000002,10,36,0.782608695652174
64397,AUDCAD,12,59.06,4,8,0.6666666666666666
64397,AUDJPY,3,-44.93,3,0,0.0
64397,AUDNZD,2,-3.5,2,0,0.0
64397,AUDUSD,11,-82.95,5,6,0.5454545454545454
64397,CADJPY,2,-2.5199999999999996,1,1,0.5
64397,CHFJPY,9,-2.8600000000000065,5,4,0.4444444444444444
64397,EURAUD,9,-114.73,6,3,0.3333333333333333
64397,EURCAD,14,-21.530000000000015,9,5,0.35714285714285715
64397,EURCHF,5,31.87999999999999,2,3,0.6
64397,EURGBP,9,-49.10000000000001,6,3,0.3333333333333333
64397,EURJPY,12,-409.78,10,2,0.16666666666666666
64397,EURUSD,37,-211.44,20,17,0.4594594594594595
64397,GBPCHF,9,166.74,3,6,0.6666666666666666
64397,GBPJPY,5,-51.38000000000002,3,2,0.4
64397,GBPUSD,21,-273.25,12,9,0.42857142857142855
64397,USDCAD,3,-126.28,2,1,0.3333333333333333
64397,USDCHF,5,-134.6,5,0,0.0
64397,USDJPY,1,35.07,0,1,1.0
64480,AUDJPY,6,-6.209999999999999,3,3,0.5
64480,AUDUSD,37,-131.92000000000002,10,27,0.7297297297297297
64480,EURCHF,1,0.68,0,1,1.0
64480,EURJPY,112,-100.98,33,79,0.7053571428571429
64480,EURUSD,170,2.510000000000005,31,139,0.8176470588235294
64480,GBPJPY,22,-57.40999999999999,7,15,0.6818181818181818
64480,GBPUSD,40,37.6,9,31,0.775
64480,NZDUSD,2,3.23,0,2,1.0
64480,USDJPY,6,-9.040000000000001,2,4,0.6666666666666666
64536,AUDCAD,2,-11.72,2,0,0.0
64536,AUDJPY,2,37.71,1,1,0.5
64536,AUDNZD,2,4.26,0,2,1.0
64536,AUDUSD,12,-52.199999999999996,6,6,0.5
64536,CADJPY,1,24.08,0,1,1.0
64536,CHFJPY,1,-7.76,1,0,0.0
64536,EURAUD,24,20.3,6,18,0.75
64536,EURCHF,6,-20.019999999999996,4,2,0.3333333333333333
64536,EURGBP,12,-155.7,8,4,0.3333333333333333
64536,EURJPY,2,-63.01,2,0,0.0
64536,EURUSD,342,-1352.8,172,170,0.49707602339181284
64536,GBPCHF,1,-18.3,1,0,0.0
64536,GBPJPY,3,-6.1,1,2,0.6666666666666666
64536,GBPUSD,16,162.0,7,9,0.5625
64536,NZDUSD,3,2.6500000000000004,1,2,0.6666666666666666
64536,USDCAD,28,-81.11000000000001,14,14,0.5
64536,USDCHF,9,27.85,2,7,0.7777777777777778
64536,USDJPY,8,20.490000000000002,3,5,0.625
64550,AUDJPY,3,-303.55999999999995,2,1,0.3333333333333333
64550,AUDUSD,30,-49.43,9,21,0.7
64550,CHFJPY,1,-2.12,1,0,0.0
64550,EURCAD,1,0.25,0,1,1.0
64550,EURGBP,1,-5.27,1,0,0.0
64550,EURJPY,136,-48.86000000000002,53,83,0.6102941176470589
64550,EURUSD,1191,-2348.93,402,789,0.6624685138539043
64550,GBPJPY,32,-179.9,15,17,0.53125
64550,GBPUSD,422,21.770000000000014,171,251,0.5947867298578199
64550,NZDUSD,1,-26.0,1,0,0.0
64550,USDCAD,5,-56.99,2,3,0.6
64550,USDCHF,98,-225.0,43,55,0.5612244897959183
64550,USDJPY,210,-360.38000000000005,102,108,0.5142857142857142
64713,EURGBP,2,-2.31,1,1,0.5
64713,EURJPY,1,1.13,0,1,1.0
64713,EURUSD,61,-117.7,34,27,0.4426229508196721
64713,GBPCHF,3,5.760000000000001,0,3,1.0
64713,GBPUSD,45,-44.199999999999996,22,23,0.5111111111111111
64713,USDCAD,1,0.87,0,1,1.0
64713,USDCHF,1,-0.77,1,0,0.0
64713,USDJPY,1,-0.66,1,0,0.0
64714,EURJPY,8,-1.7200000000000002,4,4,0.5
64714,EURUSD,142,-49.599999999999994,54,88,0.6197183098591549
64714,GBPJPY,59,-13.38,16,43,0.7288135593220338
64714,GBPUSD,125,-162.4,35,90,0.72
64714,USDJPY,6,72.13000000000001,3,3,0.5
64715,EURUSD,177,-85.8,66,111,0.6271186440677966
64715,GBPUSD,21,-9.9,7,14,0.6666666666666666
64901,AUDUSD,14,-434.0,4,10,0.7142857142857143
64901,EURGBP,5,-378.95,2,3,0.6
64901,EURUSD,142,-904.0,27,115,0.8098591549295775
64901,GBPCHF,2,18.189999999999998,0,2,1.0
64901,GBPJPY,1,2.83,0,1,1.0
64901,GBPUSD,9,32.0,1,8,0.8888888888888888
64901,USDCHF,2,53.32,0,2,1.0
64901,USDJPY,22,49.319999999999986,4,18,0.8181818181818182
64901,USDMXN,1,-8.5,1,0,0.0
64940,AUDJPY,2,-6.2,2,0,0.0
64940,AUDUSD,143,87.39,93,50,0.34965034965034963
64940,EURCHF,7,-17.91,6,1,0.14285714285714285
64940,EURGBP,15,32.29,10,5,0.3333333333333333
64940,EURJPY,118,-399.09000000000003,80,38,0.3220338983050847
64940,EURUSD,490,-1643.75,324,166,0.33877551020408164
64940,GBPJPY,87,-510.84999999999997,57,30,0.3448275862068966
64940,GBPUSD,1206,-1292.35,684,522,0.43283582089552236
64940,NZDUSD,73,-105.98,50,23,0.3150684931506849
64940,USDCAD,168,-157.76,102,66,0.39285714285714285
64940,USDCHF,214,-428.08000000000004,140,74,0.34579439252336447
64940,USDJPY,207,-610.61,126,81,0.391304347826087
65161,AUDCAD,1,0.0,1,0,0.0
65161,AUDJPY,60,-650.1699999999987,24,36,0.6
65161,AUDNZD,5,475.33,0,5,1.0
65161,AUDUSD,236,-2206.0,99,137,0.5805084745762712
65161,CADJPY,13,-998.5399999999998,5,8,0.6153846153846154
65161,CHFJPY,15,-54.64000000000007,8,7,0.4666666666666667
65161,EURAUD,20,-23.410000000000025,8,12,0.6
65161,EURCAD,15,-3306.63,9,6,0.4
65161,EURCHF,33,-738.6399999999999,17,16,0.48484848484848486
65161,EURGBP,60,-2529.49,28,32,0.5333333333333333
65161,EURJPY,212,-1174.1399999999999,106,106,0.5
65161,EURUSD,1308,13022.0,616,692,0.5290519877675841
65161,GBPCHF,105,-10938.869999999999,51,54,0.5142857142857142
65161,GBPJPY,364,-15981.109999999999,164,200,0.5494505494505495
65161,GBPUSD,1323,-12274.0,696,627,0.47392290249433106
65161,NZDUSD,51,-662.0,21,30,0.5882352941176471
65161,USDCAD,282,3243.32,149,133,0.4716312056737589
65161,USDCHF,560,-18572.81,294,266,0.475
65161,USDJPY,482,12734.26,211,271,0.5622406639004149
65161,XAGUSD,2,-312.0,2,0,0.0
65161,XAUUSD,47,-1506.0,18,29,0.6170212765957447
65256,AUDCAD,1,2.53,0,1,1.0
65256,AUDNZD,7,-3.479999999999999,2,5,0.7142857142857143
65256,AUDUSD,43,-410.33,10,33,0.7674418604651163
65256,CHFJPY,25,-4.2100000000000035,4,21,0.84
65256,EURCHF,10,8.29,3,7,0.7
65256,EURGBP,7,14.459999999999997,2,5,0.7142857142857143
65256,EURJPY,42,-56.63000000000002,4,38,0.9047619047619048
65256,EURUSD,202,-43.63999999999996,39,163,0.806930693069307
65256,GBPCHF,3,6.63,0,3,1.0
65256,GBPJPY,218,180.3,41,177,0.8119266055045872
65256,GBPUSD,102,-427.89000000000004,24,78,0.7647058823529411
65256,NZDUSD,8,13.700000000000001,1,7,0.875
65256,USDCAD,17,18.39,3,14,0.8235294117647058
65256,USDCHF,34,5.130000000000004,5,29,0.8529411764705882
65256,USDJPY,16,-85.56,4,12,0.75
65314,EURGBP,4,-109.24,1,3,0.75
65314,EURUSD,3,93.0,0,3,1.0
65314,GBPUSD,918,-9529.0,103,815,0.8877995642701525
65314,USDJPY,1,2.73,0,1,1.0
65944,AUDJPY,3,-199.68,1,2,0.6666666666666666
65944,AUDNZD,4,-46.98,2,2,0.5
65944,AUDUSD,15,85.0,7,8,0.5333333333333333
65944,EURAUD,5,-240.73000000000002,3,2,0.4
65944,EURCHF,2,93.65,1,1,0.5
65944,EURGBP,3,-25.659999999999997,1,2,0.6666666666666666
65944,EURJPY,4,-98.47,3,1,0.25
65944,EURUSD,96,-227.41,41,55,0.5729166666666666
65944,GBPUSD,54,-1968.0,28,26,0.48148148148148145
65944,NZDUSD,4,115.0,1,3,0.75
65944,USDCAD,6,-55.72,3,3,0.5
65944,USDCHF,30,413.13,8,22,0.7333333333333333
65944,USDJPY,46,-1118.41,18,28,0.6086956521739131
66201,EURUSD,637,-2157.5,126,511,0.8021978021978022
66201,USDJPY,12,-107.82000000000002,4,8,0.6666666666666666
66263,AUDUSD,321,-5476.99,192,129,0.40186915887850466
66263,EURJPY,18,-29.960000000000004,9,9,0.5
66263,EURUSD,1489,-819.3100000000001,749,740,0.49697783747481533
66263,GBPJPY,304,-612.81,145,159,0.5230263157894737
66263,GBPUSD,171,1327.2,63,108,0.631578947368421
66263,USDCAD,6,-291.47,3,3,0.5
66263,USDCHF,155,-6272.63,75,80,0.5161290322580645
66263,USDJPY,161,-1230.81,79,82,0.5093167701863354
66263,USDMXN,1,-6.67,1,0,0.0
66698,AUDUSD,8,-52.7,6,2,0.25
66698,EURGBP,1,0.0,1,0,0.0
66698,EURJPY,94,-391.03,59,35,0.3723404255319149
66698,EURUSD,98,304.1,61,37,0.37755102040816324
66698,GBPJPY,5,-122.22000000000001,5,0,0.0
66698,GBPUSD,11,-20.5,8,3,0.2727272727272727
66698,USDCAD,23,-23.32,16,7,0.30434782608695654
66698,USDCHF,5,-132.64000000000001,4,1,0.2
66698,USDJPY,14,-103.62,11,3,0.21428571428571427
66698,USDMXN,1,-5.52,1,0,0.0
66698,XAUUSD,8,-12.83,6,2,0.25
66930,EURGBP,2,9.91,1,1,0.5
66930,EURJPY,19,-137.18,12,7,0.3684210526315789
66930,EURUSD,15,-219.0,9,6,0.4
66930,GBPUSD,9,-122.0,6,3,0.3333333333333333
66930,USDCHF,68,-157.48,19,49,0.7205882352941176
66930,USDJPY,10,-96.14,8,2,0.2
67011,AUDCAD,1,6.73,0,1,1.0
67011,AUDJPY,3,-11.96,2,1,0.3333333333333333
67011,AUDUSD,16,-1.1999999999999993,8,8,0.5
67011,CHFJPY,3,37.4,0,3,1.0
67011,EURAUD,2,-7.6,1,1,0.5
67011,EURCHF,1,-2.78,1,0,0.0
67011,EURGBP,4,-14.629999999999999,3,1,0.25
67011,EURJPY,7,-113.19,5,2,0.2857142857142857
67011,EURUSD,62,-43.8,27,35,0.5645161290322581
67011,GBPJPY,1,8.96,0,1,1.0
67011,GBPUSD,24,-104.8,11,13,0.5416666666666666
67011,USDCAD,7,7.609999999999999,2,5,0.7142857142857143
67011,USDCHF,10,101.16,2,8,0.8
67011,USDJPY,11,-3.369999999999999,3,8,0.7272727272727273
67076,AUDCAD,23,291.37,5,18,0.782608695652174
67076,AUDJPY,82,-927.45,31,51,0.6219512195121951
67076,AUDNZD,2,-23.0,2,0,0.0
67076,AUDUSD,63,423.53,13,50,0.7936507936507936
67076,CADJPY,10,159.39,2,8,0.8
67076,CHFJPY,2,-49.019999999999996,1,1,0.5
67076,EURAUD,8,43.699999999999996,2,6,0.75
67076,EURCAD,8,-8.450000000000003,4,4,0.5
67076,EURCHF,8,68.82,2,6,0.75
67076,EURGBP,50,302.05,14,36,0.72
67076,EURJPY,76,987.04,9,67,0.881578947368421
67076,EURUSD,763,-4454.1,206,557,0.7300131061598951
67076,GBPCHF,1,61.03,0,1,1.0
67076,GBPJPY,18,-628.07,10,8,0.4444444444444444
67076,GBPUSD,205,-613.5900000000001,32,173,0.8439024390243902
67076,NZDUSD,46,-344.85,16,30,0.6521739130434783
67076,USDCAD,105,581.06,24,81,0.7714285714285715
67076,USDCHF,20,80.86,6,14,0.7
67076,USDJPY,147,-93.76000000000002,53,94,0.6394557823129252
67196,AUDNZD,1,8.85,0,1,1.0
67196,AUDUSD,44,-17.949999999999996,16,28,0.6363636363636364
67196,CADJPY,2,-38.31,1,1,0.5
67196,EURAUD,3,-26.43,2,1,0.3333333333333333
67196,EURCHF,4,-2.88,3,1,0.25
67196,EURGBP,10,67.6,5,5,0.5
67196,EURJPY,78,-98.18999999999997,38,40,0.5128205128205128
67196,EURUSD,986,-717.65,522,464,0.47058823529411764
67196,GBPJPY,42,-86.19,21,21,0.5
67196,GBPUSD,270,-399.14,155,115,0.42592592592592593
67196,NZDUSD,2,2.45,1,1,0.5
67196,USDCAD,69,49.28,34,35,0.5072463768115942
67196,USDCHF,134,-355.58,84,50,0.373134328358209
67196,USDJPY,135,-90.53000000000003,74,61,0.45185185185185184
67267,EURAUD,3,90.00999999999999,0,3,1.0
67267,EURGBP,10,-363.53000000000003,2,8,0.8
67267,EURJPY,14,340.49,1,13,0.9285714285714286
67267,EURUSD,55,-319.9,6,49,0.8909090909090909
67267,GBPJPY,117,287.57999999999987,18,99,0.8461538461538461
67267,GBPUSD,8,160.0,0,8,1.0
67267,USDCAD,1,0.98,0,1,1.0
67267,USDCHF,3,66.64,1,2,0.6666666666666666
67267,USDJPY,12,431.65999999999997,0,12,1.0
67361,AUDJPY,6,-701.2600000000001,4,2,0.3333333333333333
67361,AUDNZD,1,-53.03,1,0,0.0
67361,AUDUSD,19,-1510.0,15,4,0.21052631578947367
67361,EURJPY,19,-1009.01,12,7,0.3684210526315789
67361,EURUSD,258,-10166.0,172,86,0.3333333333333333
67361,GBPJPY,7,-1373.9,7,0,0.0
67361,GBPUSD,4,170.0,2,2,0.5
67361,NZDUSD,3,-90.0,2,1,0.3333333333333333
67361,USDCAD,2,-283.69,2,0,0.0
67361,USDCHF,43,-910.65,29,14,0.32558139534883723
67361,USDJPY,38,-4018.81,29,9,0.23684210526315788
67411,AUDCAD,2,-282.44,2,0,0.0
67411,AUDJPY,28,1069.8700000000001,10,18,0.6428571428571429
67411,AUDUSD,8,145.0,2,6,0.75
67411,CADJPY,5,327.44,1,4,0.8
67411,EURAUD,1,6.32,0,1,1.0
67411,EURCHF,1,-99.81,1,0,0.0
67411,EURGBP,6,14.190000000000012,1,5,0.8333333333333334
67411,EURJPY,21,275.06,9,12,0.5714285714285714
67411,EURUSD,73,-424.4,36,37,0.5068493150684932
67411,GBPJPY,73,-4374.77,43,30,0.410958904109589
67411,GBPUSD,16,-527.0,7,9,0.5625
67411,NZDUSD,19,702.0,8,11,0.5789473684210527
67411,USDCAD,1,69.58,0,1,1.0
67411,USDCHF,3,-12.66,1,2,0.6666666666666666
67411,USDJPY,17,501.77,6,11,0.6470588235294118
67411,USDMXN,36,1596.71,13,23,0.6388888888888888
67411,USDTRY,5,-120.49999999999999,1,4,0.8
67411,XAUUSD,6,427.51,3,3,0.5
67905,EURUSD,168,-419.85999999999996,67,101,0.6011904761904762
67905,USDJPY,2,-1.8400000000000003,1,1,0.5
67987,AUDJPY,2,-4.02,2,0,0.0
67987,AUDNZD,3,-1.5500000000000003,2,1,0.3333333333333333
67987,AUDUSD,287,-77.88,147,140,0.4878048780487805
67987,CHFJPY,133,-72.6,60,73,0.5488721804511278
67987,EURAUD,29,-132.61000000000004,13,16,0.5517241379310345
67987,EURGBP,1,7.98,0,1,1.0
67987,EURUSD,900,-1996.68,413,487,0.5411111111111111
67987,GBPCHF,83,-1207.28,43,40,0.4819277108433735
67987,GBPJPY,158,-252.5,93,65,0.41139240506329117
67987,GBPUSD,403,-153.53,178,225,0.5583126550868487
67987,NZDUSD,11,-32.13,9,2,0.18181818181818182
67987,USDCAD,1,0.17,0,1,1.0
67987,USDCHF,93,-156.81,48,45,0.4838709677419355
67987,USDJPY,78,-94.97,53,25,0.32051282051282054
68150,AUDUSD,10,-1.7099999999999993,3,7,0.7
68150,CADJPY,3,35.709999999999994,2,1,0.3333333333333333
68150,CHFJPY,8,-19.25,4,4,0.5
68150,EURAUD,10,20.1,1,9,0.9
68150,EURCHF,90,-2368.8,8,82,0.9111111111111111
68150,EURJPY,7,-1339.99,2,5,0.7142857142857143
68150,EURUSD,1026,-2026.7,169,857,0.8352826510721247
68150,GBPJPY,2,14.94,0,2,1.0
68150,GBPUSD,33,141.5,5,28,0.8484848484848485
68150,NZDUSD,23,-30.5,12,11,0.4782608695652174
68150,USDCAD,32,-94.5,7,25,0.78125
68150,USDCHF,170,-1517.21,36,134,0.788235294117647
68150,USDJPY,34,273.22,4,30,0.8823529411764706
68150,XAGUSD,22,-2.8000000000000007,9,13,0.5909090909090909
68305,AUDUSD,44,-60.71000000000001,29,15,0.3409090909090909
68305,EURJPY,8,-77.08,6,2,0.25
68305,EURUSD,462,-561.74,279,183,0.3961038961038961
68305,GBPJPY,202,-579.91,117,85,0.4207920792079208
68305,GBPUSD,285,-893.7,178,107,0.37543859649122807
68305,XAUUSD,24,-72.22,21,3,0.125
68381,AUDUSD,11,-7388.0,10,1,0.09090909090909091
68381,EURAUD,4,1161.02,1,3,0.75
68381,EURCHF,1,-4955.08,1,0,0.0
68381,EURJPY,8,12902.86,2,6,0.75
68381,EURUSD,295,-58218.5,106,189,0.6406779661016949
68381,GBPUSD,2,1370.0,1,1,0.5
68381,USDJPY,2,472.23,0,2,1.0
68430,EURJPY,20,-213.79000000000002,8,12,0.6
68430,EURUSD,171,215.82,80,91,0.5321637426900585
68430,GBPJPY,2,-91.33000000000001,2,0,0.0
68430,NZDUSD,4,-13.000000000000004,2,2,0.5
68430,USDJPY,10,-9.68,4,6,0.6
68675,AUDUSD,221,-457.82,59,162,0.7330316742081447
68675,EURCHF,2,-110.37,2,0,0.0
68675,EURJPY,7,-210.01,3,4,0.5714285714285714
68675,EURUSD,322,-2658.97,105,217,0.6739130434782609
68675,GBPUSD,311,-89.73999999999994,100,211,0.6784565916398714
68675,USDCAD,128,-102.32,36,92,0.71875
68675,USDCHF,54,-86.49000000000001,14,40,0.7407407407407407
68675,USDJPY,30,410.24,5,25,0.8333333333333334
68705,AUDCAD,2,187.89,0,2,1.0
68705,AUDUSD,32,592.0,12,20,0.625
68705,EURCHF,1,1.48,0,1,1.0
68705,EURJPY,384,-3984.7,137,247,0.6432291666666666
68705,EURUSD,279,2229.7,83,196,0.7025089605734767
68705,GBPJPY,437,-2080.05,162,275,0.6292906178489702
68705,GBPUSD,192,1745.3,60,132,0.6875
68705,USDJPY,216,1549.19,68,148,0.6851851851851852
68705,USDMXN,1,-368.78,1,0,0.0
68705,XAUUSD,35,1770.0,7,28,0.8
68718,AUDCAD,2,3309.91,0,2,1.0
68718,AUDJPY,2,5165.42,0,2,1.0
68718,AUDNZD,1,1068.48,0,1,1.0
68718,AUDUSD,7,-109360.0,4,3,0.42857142857142855
68718,CADJPY,4,4883.59,0,4,1.0
68718,CHFJPY,10,401.4200000000001,5,5,0.5
68718,EURAUD,1,3172.26,0,1,1.0
68718,EURCHF,11,6168.4,1,10,0.9090909090909091
68718,EURGBP,4,-118.55999999999997,2,2,0.5
68718,EURJPY,4,6178.13,0,4,1.0
68718,EURUSD,28,18260.0,8,20,0.7142857142857143
68718,GBPCHF,1,945.32,0,1,1.0
68718,GBPJPY,6,5295.1,0,6,1.0
68718,GBPUSD,17,2160.0,5,12,0.7058823529411765
68718,NZDUSD,7,-38310.0,5,2,0.2857142857142857
68718,USDCAD,13,-24562.62,6,7,0.5384615384615384
68718,USDCHF,6,2530.7700000000004,2,4,0.6666666666666666
68718,USDJPY,5,77.63,1,4,0.8
68718,USDMXN,7,204.83999999999986,3,4,0.5714285714285714
68721,AUDUSD,1,-11.0,1,0,0.0
68721,CHFJPY,1,0.0,1,0,0.0
68721,EURGBP,14,-61.90999999999998,9,5,0.35714285714285715
68721,EURJPY,1,84.49,0,1,1.0
68721,EURUSD,136,2385.2000000000007,56,80,0.5882352941176471
68721,GBPJPY,2,236.83999999999997,0,2,1.0
68721,GBPUSD,7,241.4,5,2,0.2857142857142857
68721,NZDUSD,3,33.7,1,2,0.6666666666666666
68721,USDCAD,2,-183.51999999999998,2,0,0.0
68721,USDCHF,58,-2927.91,50,8,0.13793103448275862
68721,USDJPY,20,672.01,5,15,0.75
68750,AUDUSD,8,-91.51,4,4,0.5
68750,EURGBP,2,-25.8,1,1,0.5
68750,EURJPY,3,-14.799999999999999,1,2,0.6666666666666666
68750,EURUSD,473,524.97,177,296,0.6257928118393234
68750,GBPJPY,3,-23.779999999999998,1,2,0.6666666666666666
68750,GBPUSD,305,-884.4,115,190,0.6229508196721312
68750,USDCAD,9,0.21000000000000035,2,7,0.7777777777777778
68750,USDCHF,5,7.62,0,5,1.0
68750,USDJPY,8,-146.98,5,3,0.375
68750,XAGUSD,14,301.82,3,11,0.7857142857142857
68750,XAUUSD,2,64.23,0,2,1.0
68781,AUDUSD,10,-86.0,6,4,0.4
68781,EURGBP,1,1.97,0,1,1.0
68781,EURUSD,370,-1957.3799999999999,180,190,0.5135135135135135
68781,GBPUSD,52,-186.0,25,27,0.5192307692307693
68781,NZDUSD,8,-107.0,5,3,0.375
68781,USDCAD,3,-16.78,3,0,0.0
68781,USDCHF,2,7.859999999999999,1,1,0.5
68781,USDJPY,9,-103.95,8,1,0.1111111111111111
68781,XAGUSD,1,-27.0,1,0,0.0
68821,AUDNZD,4,10.27,0,4,1.0
68821,AUDUSD,18,-4.6000000000000005,9,9,0.5
68821,CADJPY,1,1.49,0,1,1.0
68821,EURAUD,8,37.4,2,6,0.75
68821,EURCAD,7,51.55,0,7,1.0
68821,EURCHF,6,27.0,0,6,1.0
68821,EURGBP,1,4.64,0,1,1.0
68821,EURJPY,8,42.11,0,8,1.0
68821,EURUSD,26,163.5,6,20,0.7692307692307693
68821,GBPJPY,11,157.95000000000002,2,9,0.8181818181818182
68821,GBPUSD,13,130.7,3,10,0.7692307692307693
68821,NZDUSD,2,-301.4,1,1,0.5
68821,USDCAD,16,57.160000000000004,5,11,0.6875
68821,USDCHF,11,68.67999999999999,1,10,0.9090909090909091
68821,USDJPY,33,266.58,5,28,0.8484848484848485
68910,AUDUSD,7,19.7,1,6,0.8571428571428571
68910,EURCHF,1,-2.04,1,0,0.0
68910,EURGBP,12,-477.1700000000001,6,6,0.5
68910,EURJPY,29,496.36,14,15,0.5172413793103449
68910,EURUSD,461,-17493.72,180,281,0.6095444685466378
68910,GBPCHF,2,57.31999999999999,1,1,0.5
68910,GBPJPY,25,-59.00999999999971,11,14,0.56
68910,GBPUSD,359,-14107.380000000001,164,195,0.5431754874651811
68910,NZDUSD,2,8.200000000000001,1,1,0.5
68910,USDCAD,2,2.3499999999999996,1,1,0.5
68910,USDCHF,25,-940.61,7,18,0.72
68910,USDJPY,28,-648.74,15,13,0.4642857142857143
68910,XAGUSD,1,-54.0,1,0,0.0
68910,XAUUSD,1,-209.68,1,0,0.0
68994,AUDJPY,3,-2.99,3,0,0.0
68994,AUDUSD,100,-399.4,47,53,0.53
68994,EURAUD,3,8.85,1,2,0.6666666666666666
68994,EURCHF,14,-455.61,8,6,0.42857142857142855
68994,EURGBP,10,7.839999999999988,6,4,0.4
68994,EURJPY,41,203.14,13,28,0.6829268292682927
68994,EURUSD,220,-603.55,118,102,0.4636363636363636
68994,GBPCHF,22,295.42,10,12,0.5454545454545454
68994,GBPJPY,31,-325.49999999999994,11,20,0.6451612903225806
68994,GBPUSD,157,-444.46,83,74,0.4713375796178344
68994,NZDUSD,106,60.84,51,55,0.5188679245283019
68994,USDCAD,69,-1459.54,30,39,0.5652173913043478
68994,USDCHF,163,105.26999999999994,65,98,0.6012269938650306
68994,USDJPY,66,-1028.42,35,31,0.4696969696969697
69084,AUDCAD,29,-108.24,18,11,0.3793103448275862
69084,AUDJPY,102,21.919999999999984,52,50,0.49019607843137253
69084,AUDNZD,3,-24.0,2,1,0.3333333333333333
69084,AUDUSD,313,-475.74,178,135,0.43130990415335463
69084,CADJPY,32,-91.87,14,18,0.5625
69084,CHFJPY,22,-17.000000000000004,10,12,0.5454545454545454
69084,EURAUD,38,-59.34000000000001,23,15,0.39473684210526316
69084,EURCAD,40,62.919999999999995,17,23,0.575
69084,EURCHF,113,104.79,59,54,0.4778761061946903
69084,EURGBP,64,20.319999999999993,34,30,0.46875
69084,EURJPY,224,48.95999999999998,122,102,0.45535714285714285
69084,EURUSD,1900,-9807.98,720,1180,0.6210526315789474
69084,GBPCHF,129,-360.03,71,58,0.4496124031007752
69084,GBPJPY,195,69.50000000000001,104,91,0.4666666666666667
69084,GBPUSD,3586,-21814.16,1536,2050,0.5716675962074735
69084,NZDUSD,172,-135.14000000000001,82,90,0.5232558139534884
69084,USDCAD,30,-59.019999999999996,19,11,0.36666666666666664
69084,USDCHF,335,-2088.9900000000002,113,222,0.6626865671641791
69084,USDJPY,338,109.79000000000019,109,229,0.6775147928994083
69084,USDMXN,2,1.25,0,2,1.0
69084,USDTRY,2,-17.069999999999997,1,1,0.5
69084,XAGUSD,20,-35.800000000000004,10,10,0.5
69084,XAUUSD,122,-239.87,71,51,0.4180327868852459
69098,AUDJPY,7,22.249999999999996,3,4,0.5714285714285714
69098,AUDUSD,14,-183.93,11,3,0.21428571428571427
69098,EURAUD,9,73.56,4,5,0.5555555555555556
69098,EURCAD,3,7.920000000000002,1,2,0.6666666666666666
69098,EURCHF,158,-255.82,50,108,0.6835443037974683
69098,EURGBP,5,-28.13,3,2,0.4
69098,EURJPY,15,-200.53,9,6,0.4
69098,EURUSD,2712,-24939.65,882,1830,0.6747787610619469
69098,GBPJPY,202,-1923.8799999999999,95,107,0.5297029702970297
69098,GBPUSD,43,-224.82,16,27,0.627906976744186
69098,NZDUSD,3,-3.13,2,1,0.3333333333333333
69098,USDCAD,17,-130.20000000000002,12,5,0.29411764705882354
69098,USDCHF,79,287.92,28,51,0.6455696202531646
69098,USDJPY,24,-48.39,10,14,0.5833333333333334
69098,XAUUSD,290,-3487.79,126,164,0.5655172413793104
69135,EURUSD,109,-393.0,29,80,0.7339449541284404
69135,USDCHF,49,-139.77999999999997,21,28,0.5714285714285714
69135,USDJPY,1,-9.65,1,0,0.0
69576,AUDCAD,17,-17.859999999999996,9,8,0.47058823529411764
69576,AUDJPY,30,1157.8799999999999,22,8,0.26666666666666666
69576,AUDNZD,14,67.30999999999999,9,5,0.35714285714285715
69576,AUDUSD,38,295.1,16,22,0.5789473684210527
69576,CADJPY,41,-1376.8700000000001,28,13,0.3170731707317073
69576,CHFJPY,36,-303.40999999999997,25,11,0.3055555555555556
69576,EURAUD,43,-1198.57,25,18,0.4186046511627907
69576,EURCAD,48,-2909.5099999999998,32,16,0.3333333333333333
69576,EURCHF,34,-1892.01,23,11,0.3235294117647059
69576,EURGBP,51,1235.9299999999998,26,25,0.49019607843137253
69576,EURJPY,67,-1739.7899999999997,38,29,0.43283582089552236
69576,EURUSD,151,2431.9,73,78,0.5165562913907285
69576,GBPCHF,58,955.7600000000002,37,21,0.3620689655172414
69576,GBPJPY,148,-3584.4199999999996,71,77,0.5202702702702703
69576,GBPUSD,110,-275.63,59,51,0.4636363636363636
69576,NZDUSD,17,-528.7,13,4,0.23529411764705882
69576,USDCAD,59,-949.4399999999999,33,26,0.4406779661016949
69576,USDCHF,53,826.62,27,26,0.49056603773584906
69576,USDJPY,45,-1586.68,29,16,0.35555555555555557
69585,AUDUSD,17,-258.0,12,5,0.29411764705882354
69585,EURJPY,63,129.76999999999987,26,37,0.5873015873015873
69585,EURUSD,830,-20126.4,305,525,0.6325301204819277
69585,GBPUSD,7,-5.0,1,6,0.8571428571428571
69585,USDCAD,7,32.790000000000006,2,5,0.7142857142857143
69585,USDCHF,2,-15.110000000000001,1,1,0.5
69585,USDJPY,41,-743.35,20,21,0.5121951219512195
69599,AUDUSD,117,-567.29,53,64,0.5470085470085471
69599,AUDUSDr,8,-45.0,3,5,0.625
69599,EURCHF,8,39.38,4,4,0.5
69599,EURGBP,2,-35.04,2,0,0.0
69599,EURJPY,1,-7.64,1,0,0.0
69599,EURUSD,2109,-13322.199999999999,758,1351,0.64058795637743
69599,EURUSDr,2,7.88,0,2,1.0
69599,GBPUSD,143,606.74,48,95,0.6643356643356644
69599,NZDUSD,36,-93.18999999999998,12,24,0.6666666666666666
69599,NZDUSDr,6,-13.6,2,4,0.6666666666666666
69599,USDCAD,1,1.97,0,1,1.0
69599,USDCHF,975,-8851.1,389,586,0.601025641025641
69599,USDCHFr,1,4.39,0,1,1.0
69599,USDJPY,2193,-10819.44,862,1331,0.6069311445508436
69599,USDJPYr,3,-3.9899999999999993,1,2,0.6666666666666666
69599,XAGUSD,3,-28.8,3,0,0.0
69599,XAUUSD,9,-37.85,4,5,0.5555555555555556
69600,AUDCAD,1,-26.29,1,0,0.0
69600,AUDJPY,3,23.049999999999997,0,3,1.0
69600,AUDUSD,7,-81.0,3,4,0.5714285714285714
69600,EURAUD,7,40.019999999999996,1,6,0.8571428571428571
69600,EURCHF,2,-17.36,1,1,0.5
69600,EURGBP,1,-27.94,1,0,0.0
69600,EURJPY,19,6.189999999999994,7,12,0.631578947368421
69600,EURUSD,188,-999.0,79,109,0.5797872340425532
69600,GBPCHF,2,-316.33,2,0,0.0
69600,GBPJPY,14,151.84,5,9,0.6428571428571429
69600,GBPUSD,54,-297.0,22,32,0.5925925925925926
69600,NZDUSD,3,-79.0,1,2,0.6666666666666666
69600,USDCAD,8,73.55,2,6,0.75
69600,USDCHF,11,48.41,1,10,0.9090909090909091
69600,USDJPY,21,1.9199999999999982,8,13,0.6190476190476191
69820,AUDJPY,23,453.28999999999996,8,15,0.6521739130434783
69820,AUDUSD,72,-172.0,36,36,0.5
69820,CADJPY,6,131.48,1,5,0.8333333333333334
69820,EURAUD,14,-201.88,6,8,0.5714285714285714
69820,EURCAD,3,-353.81,3,0,0.0
69820,EURGBP,8,-1575.12,6,2,0.25
69820,EURJPY,140,3025.67,43,97,0.6928571428571428
69820,EURUSD,398,-6619.0,229,169,0.42462311557788945
69820,GBPCHF,14,107.61,5,9,0.6428571428571429
69820,GBPJPY,206,-476.2700000000001,94,112,0.5436893203883495
69820,GBPUSD,739,-5038.0,357,382,0.516914749661705
69820,USDCAD,53,-582.1400000000001,29,24,0.4528301886792453
69820,USDCHF,8,-373.88,6,2,0.25
69820,USDJPY,261,-660.95,116,145,0.5555555555555556
69820,USDTRY,3,-274.74,3,0,0.0
69820,XAUUSD,29,-590.2,18,11,0.3793103448275862
69829,EURJPY,3,-2875.97,2,1,0.3333333333333333
69829,EURUSD,68,2780.6,30,38,0.5588235294117647
69829,GBPUSD,73,-14635.0,46,27,0.3698630136986301
69829,USDJPY,38,10880.300000000001,15,23,0.6052631578947368
69830,AUDJPY,38,-159.0100000000001,13,25,0.6578947368421053
69830,EURCAD,6,-623.0100000000001,3,3,0.5
69830,EURGBP,1,-141.13,1,0,0.0
69830,EURJPY,11,3.580000000000039,8,3,0.2727272727272727
69830,EURUSD,17,-992.0,10,7,0.4117647058823529
69830,GBPCHF,1,77.14,0,1,1.0
69830,GBPJPY,49,-1925.89,30,19,0.3877551020408163
69830,GBPUSD,4,276.0,1,3,0.75
69830,USDCAD,1,16.08,0,1,1.0
69830,USDCHF,6,-514.75,3,3,0.5
69830,USDJPY,14,-550.61,11,3,0.21428571428571427
70477,AUDUSD,1,63.0,0,1,1.0
70477,EURCHF,1,-52.49,1,0,0.0
70477,EURJPY,20,55.54,10,10,0.5
70477,EURUSD,134,-720.15,83,51,0.3805970149253731
70477,GBPJPY,64,-108.77,35,29,0.453125
70477,GBPUSD,31,16.5,16,15,0.4838709677419355
70477,NZDUSD,1,13.0,0,1,1.0
70477,USDCAD,2,-54.51,1,1,0.5
70477,USDJPY,8,35.96,6,2,0.25
70522,AUDUSD,2,-1.0,2,0,0.0
70522,EURUSD,56,6.0,27,29,0.5178571428571429
70522,GBPUSD,19,-650.0,10,9,0.47368421052631576
70522,USDCAD,11,298.58,2,9,0.8181818181818182
70522,USDCHF,49,-265.26000000000005,24,25,0.5102040816326531
70522,USDJPY,1,1.91,0,1,1.0
71348,AUDCAD,1,-125.53,1,0,0.0
71348,AUDJPY,2,4.34,0,2,1.0
71348,AUDNZD,7,26.58,0,7,1.0
71348,AUDUSD,15,-31.159999999999997,2,13,0.8666666666666667
71348,CADJPY,9,-52.1,3,6,0.6666666666666666
71348,CHFJPY,5,16.79,0,5,1.0
71348,EURAUD,23,-314.38,4,19,0.8260869565217391
71348,EURCAD,11,56.68,1,10,0.9090909090909091
71348,EURCHF,3,-18.94,1,2,0.6666666666666666
71348,EURGBP,75,16.92000000000001,5,70,0.9333333333333333
71348,EURJPY,108,320.2,3,105,0.9722222222222222
71348,EURUSD,202,-128.24000000000004,9,193,0.9554455445544554
71348,GBPCHF,1,0.74,0,1,1.0
71348,GBPJPY,51,575.86,4,47,0.9215686274509803
71348,GBPUSD,94,-822.1,5,89,0.9468085106382979
71348,NZDUSD,5,10.2,0,5,1.0
71348,USDCAD,35,127.17,1,34,0.9714285714285714
71348,USDCHF,7,-80.66000000000001,1,6,0.8571428571428571
71348,USDJPY,12,32.75,0,12,1.0
72067,AUDJPY,11,-133.19,9,2,0.18181818181818182
72067,AUDUSD,119,-39.34,54,65,0.5462184873949579
72067,CADJPY,45,12.840000000000002,15,30,0.6666666666666666
72067,CHFJPY,28,-4.629999999999999,13,15,0.5357142857142857
72067,EURCHF,24,-89.45,9,15,0.625
72067,EURGBP,92,-17.299999999999997,36,56,0.6086956521739131
72067,EURJPY,178,-326.68,69,109,0.6123595505617978
72067,EURUSD,1104,-1787.77,440,664,0.6014492753623188
72067,GBPCHF,13,-13.399999999999997,6,7,0.5384615384615384
72067,GBPJPY,87,-52.53,28,59,0.6781609195402298
72067,GBPUSD,27,-199.0,20,7,0.25925925925925924
72067,NZDUSD,111,95.66000000000001,42,69,0.6216216216216216
72067,USDCAD,71,12.95,21,50,0.704225352112676
72067,USDCHF,46,-83.03999999999999,25,21,0.45652173913043476
72067,USDJPY,940,-597.72,308,632,0.6723404255319149
72067,XAUUSD,7,-4.720000000000001,3,4,0.5714285714285714
72086,AUDUSD,2,84.0,0,2,1.0
72086,EURAUD,2,77.89,0,2,1.0
72086,EURJPY,2,-84.52,2,0,0.0
72086,EURUSD,89,-1189.0,30,59,0.6629213483146067
72086,GBPJPY,7,-719.26,6,1,0.14285714285714285
72086,GBPUSD,12,292.0,3,9,0.75
72086,USDCAD,2,110.16,0,2,1.0
72086,USDCHF,3,77.03,0,3,1.0
72086,USDJPY,3,-63.38,1,2,0.6666666666666666
72303,AUDCAD,2,-66.80000000000001,1,1,0.5
72303,AUDNZD,2,-46.650000000000006,2,0,0.0
72303,AUDUSD,69,-238.76,29,40,0.5797101449275363
72303,EURAUD,41,-451.94,27,14,0.34146341463414637
72303,EURCHF,9,107.11,5,4,0.4444444444444444
72303,EURGBP,8,-177.1,6,2,0.25
72303,EURJPY,5,-82.69,4,1,0.2
72303,EURUSD,272,-176.45,119,153,0.5625
72303,GBPCHF,10,-113.06,6,4,0.4
72303,GBPJPY,163,-171.47000000000006,87,76,0.4662576687116564
72303,GBPUSD,329,-108.77999999999997,141,188,0.5714285714285714
72303,NZDUSD,29,-22.440000000000005,13,16,0.5517241379310345
72303,USDCAD,30,-230.96,15,15,0.5
72303,USDCHF,88,-262.93,46,42,0.4772727272727273
72303,USDJPY,6,-31.78,5,1,0.16666666666666666
72303,USDMXN,1,15.78,0,1,1.0
72452,AUDCAD,16,-50.72,10,6,0.375
72452,AUDJPY,10,-48.72,8,2,0.2
72452,AUDNZD,68,-14.859999999999994,46,22,0.3235294117647059
72452,AUDUSD,73,-118.15,39,34,0.4657534246575342
72452,CADJPY,13,-27.75,7,6,0.46153846153846156
72452,CHFJPY,9,-94.21000000000001,6,3,0.3333333333333333
72452,EURAUD,162,-566.2099999999999,80,82,0.5061728395061729
72452,EURCAD,6,-17.6,3,3,0.5
72452,EURCHF,29,-22.36,17,12,0.41379310344827586
72452,EURGBP,96,-104.78,56,40,0.4166666666666667
72452,EURJPY,239,-106.34,132,107,0.4476987447698745
72452,EURUSD,760,-1099.21,345,415,0.5460526315789473
72452,GBPCHF,63,-96.86,37,26,0.4126984126984127
72452,GBPJPY,49,-159.3,33,16,0.32653061224489793
72452,GBPUSD,360,-891.68,181,179,0.49722222222222223
72452,NZDUSD,45,-108.96,23,22,0.4888888888888889
72452,USDCAD,256,-308.03999999999996,126,130,0.5078125
72452,USDCHF,344,-424.19,168,176,0.5116279069767442
72452,USDJPY,332,-877.13,173,159,0.4789156626506024
73364,EURUSD,1632,-4877.71,399,1233,0.7555147058823529
73436,AUDCAD,11,-172.73,6,5,0.45454545454545453
73436,AUDJPY,38,-474.03999999999996,18,20,0.5263157894736842
73436,AUDNZD,5,-15.76,2,3,0.6
73436,AUDUSD,66,211.49,20,46,0.696969696969697
73436,CADJPY,23,-18.939999999999994,9,14,0.6086956521739131
73436,CHFJPY,6,15.7,1,5,0.8333333333333334
73436,EURAUD,6,-56.209999999999994,1,5,0.8333333333333334
73436,EURCAD,7,-10.369999999999997,4,3,0.42857142857142855
73436,EURCHF,19,-89.69000000000001,8,11,0.5789473684210527
73436,EURGBP,53,-161.11,14,39,0.7358490566037735
73436,EURJPY,56,-82.31000000000003,18,38,0.6785714285714286
73436,EURUSD,152,319.26,49,103,0.6776315789473685
73436,GBPCHF,6,16.61,1,5,0.8333333333333334
73436,GBPJPY,21,-555.9399999999999,14,7,0.3333333333333333
73436,GBPUSD,117,-237.39000000000001,39,78,0.6666666666666666
73436,NZDUSD,38,-151.3,13,25,0.6578947368421053
73436,USDCAD,47,-99.16999999999999,15,32,0.6808510638297872
73436,USDCHF,29,288.07,7,22,0.7586206896551724
73436,USDJPY,114,77.78000000000003,31,83,0.7280701754385965
73500,AUDJPY,1,-0.74,1,0,0.0
73500,EURUSD,111,-122.2,53,58,0.5225225225225225
73500,GBPJPY,2,-3.1100000000000003,1,1,0.5
73500,GBPUSD,15,36.7,7,8,0.5333333333333333
73587,AUDUSD,1,70.0,0,1,1.0
73587,GBPUSD,345,-22227.05,162,183,0.5304347826086957
73587,USDCAD,7,-150.22999999999993,3,4,0.5714285714285714
73587,USDCHF,39,-8734.56,10,29,0.7435897435897436
73735,AUDUSD,5,105.0,1,4,0.8
73735,EURJPY,1,-16.02,1,0,0.0
73735,EURUSD,463,-3353.3,172,291,0.6285097192224622
73735,GBPUSD,348,-3206.3,155,193,0.5545977011494253
73735,USDCHF,7,-235.04,5,2,0.2857142857142857
73735,USDJPY,3,-135.14000000000001,1,2,0.6666666666666666
73759,AUDCAD,5,-80.55,4,1,0.2
73759,AUDJPY,6,392.53,2,4,0.6666666666666666
73759,AUDUSD,495,-754.3,308,187,0.37777777777777777
73759,CADJPY,4,101.86999999999999,2,2,0.5
73759,CHFJPY,4,0.17999999999999972,2,2,0.5
73759,EURAUD,30,-286.77,23,7,0.23333333333333334
73759,EURCAD,6,-219.24,6,0,0.0
73759,EURCHF,12,-45.39,8,4,0.3333333333333333
73759,EURGBP,100,-181.53000000000003,61,39,0.39
73759,EURJPY,2150,-3053.35,1291,859,0.3995348837209302
73759,EURUSD,1065,-1342.2,625,440,0.4131455399061033
73759,GBPCHF,81,-830.09,61,20,0.24691358024691357
73759,GBPJPY,972,-3484.52,586,386,0.39711934156378603
73759,GBPUSD,1359,-1935.0,816,543,0.3995584988962472
73759,NZDUSD,10,46.5,5,5,0.5
73759,USDCAD,181,-474.6,118,63,0.34806629834254144
73759,USDCHF,200,-2213.37,127,73,0.365
73759,USDJPY,152,-3184.39,98,54,0.35526315789473684
73759,USDMXN,1,-2.62,1,0,0.0
73759,XAGUSD,1,-5.0,1,0,0.0
73815,EURUSD,887,-3383.0,124,763,0.8602029312288614
73833,AUDUSD,6,-41.0,4,2,0.3333333333333333
73833,CHFJPY,4,-11.63,3,1,0.25
73833,EURGBP,16,63.499999999999964,6,10,0.625
73833,EURJPY,3,-176.79999999999998,1,2,0.6666666666666666
73833,EURUSD,144,-561.0,63,81,0.5625
73833,GBPJPY,5,166.79999999999998,2,3,0.6
73833,GBPUSD,27,123.5,9,18,0.6666666666666666
73833,USDCAD,1,-198.09,1,0,0.0
73833,USDCHF,12,-628.76,6,6,0.5
73833,USDJPY,25,-1104.82,14,11,0.44
74096,AUDCAD,5,-138.44,4,1,0.2
74096,AUDJPY,4,198.39,1,3,0.75
74096,AUDNZD,4,-12.07,3,1,0.25
74096,AUDUSD,21,36.26,11,10,0.47619047619047616
74096,CHFJPY,12,39.050000000000004,4,8,0.6666666666666666
74096,EURAUD,8,9.16,4,4,0.5
74096,EURCAD,15,-51.92999999999999,6,9,0.6
74096,EURCHF,9,79.16,4,5,0.5555555555555556
74096,EURGBP,14,-57.22,9,5,0.35714285714285715
74096,EURJPY,39,-634.67,22,17,0.4358974358974359
74096,EURUSD,57,-379.03999999999996,20,37,0.6491228070175439
74096,GBPCHF,18,-55.910000000000004,12,6,0.3333333333333333
74096,GBPJPY,15,45.33,6,9,0.6
74096,GBPUSD,34,-2387.95,22,12,0.35294117647058826
74096,NZDUSD,12,-108.71000000000001,8,4,0.3333333333333333
74096,USDCAD,30,-225.31,19,11,0.36666666666666664
74096,USDCHF,23,-361.39,14,9,0.391304347826087
74096,USDJPY,25,32.10000000000001,11,14,0.56
74096,XAGUSD,1,2.6,0,1,1.0
74115,AUDJPY,7,-281.66999999999996,3,4,0.5714285714285714
74115,AUDUSD,28,-988.2,16,12,0.42857142857142855
74115,CHFJPY,9,-62.81,4,5,0.5555555555555556
74115,EURCHF,21,-608.6,11,10,0.47619047619047616
74115,EURGBP,16,15.830000000000041,7,9,0.5625
74115,EURJPY,6,-76.20999999999998,4,2,0.3333333333333333
74115,EURUSD,33,-14.399999999999977,16,17,0.5151515151515151
74115,GBPJPY,11,187.12,5,6,0.5454545454545454
74115,GBPUSD,26,872.4,7,19,0.7307692307692307
74115,NZDUSD,9,89.0,5,4,0.4444444444444444
74115,USDCAD,32,-831.5899999999999,16,16,0.5
74115,USDCHF,30,714.74,9,21,0.7
74115,USDJPY,30,305.55000000000007,12,18,0.6
74129,AUDUSD,13,-784.0,4,9,0.6923076923076923
74129,EURGBP,29,-245.86,13,16,0.5517241379310345
74129,EURUSD,218,-727.1,115,103,0.4724770642201835
74129,GBPUSD,31,126.0,10,21,0.6774193548387096
74129,USDCAD,5,55.52,1,4,0.8
74129,USDCHF,32,-229.5,12,20,0.625
74129,USDJPY,36,480.52,15,21,0.5833333333333334
74252,EURJPY,4,-20.22,2,2,0.5
74252,EURUSD,126,-660.0,56,70,0.5555555555555556
74252,GBPJPY,38,-620.94,24,14,0.3684210526315789
74252,GBPUSD,9,113.0,4,5,0.5555555555555556
74252,USDCHF,1,0.0,1,0,0.0
74252,USDJPY,10,5.049999999999997,4,6,0.6
74254,AUDJPY,3,184.72,0,3,1.0
74254,AUDNZD,1,121.49,0,1,1.0
74254,AUDUSD,5,-1041.4,2,3,0.6
74254,EURJPY,21,1237.3799999999999,3,18,0.8571428571428571
74254,EURUSD,63,2941.5,17,46,0.7301587301587301
74254,GBPJPY,1,-21.9,1,0,0.0
74254,GBPUSD,16,-3937.0,3,13,0.8125
74254,NZDUSD,6,534.0,1,5,0.8333333333333334
74254,USDCAD,7,894.26,0,7,1.0
74254,USDCHF,4,162.45,1,3,0.75
74254,USDJPY,21,811.11,4,17,0.8095238095238095
74254,USDMXN,1,-134.85,1,0,0.0
74254,XAUUSD,1,363.1,0,1,1.0
74511,AUDUSD,5,-49.3,3,2,0.4
74511,EURUSD,752,-20305.12,372,380,0.5053191489361702
74511,GBPJPY,14,-1796.2800000000027,5,9,0.6428571428571429
74630,EURGBP,1,-144.13,1,0,0.0
74630,EURUSD,248,-5265.95,130,118,0.47580645161290325
74630,GBPUSD,2,-72.8,1,1,0.5
74630,USDCHF,4,39.209999999999994,2,2,0.5
74630,USDJPY,6,-40.59000000000001,3,3,0.5
74630,XAUUSD,1,-1.2,1,0,0.0
74659,AUDUSD,114,-588.9699999999999,16,98,0.8596491228070176
74659,EURUSD,82,44.69999999999999,9,73,0.8902439024390244
74659,GBPUSD,8,9.6,2,6,0.75
74659,USDCHF,3,8.18,0,3,1.0
74659,USDJPY,17,39.39,2,15,0.8823529411764706
74914,AUDUSD,14,357.44,2,12,0.8571428571428571
74914,EURUSD,6,-219.46,2,4,0.6666666666666666
74914,GBPUSD,7,89.6,1,6,0.8571428571428571
74914,NZDUSD,1,-30.8,1,0,0.0
74914,USDCHF,2,14.38,0,2,1.0
74914,USDJPY,166,-4946.43,39,127,0.7650602409638554
74935,AUDCAD,1,-10.95,1,0,0.0
74935,AUDJPY,15,44.38,2,13,0.8666666666666667
74935,AUDUSD,9,-26.4,2,7,0.7777777777777778
74935,EURCHF,22,-15.58,4,18,0.8181818181818182
74935,EURGBP,21,-20.35,4,17,0.8095238095238095
74935,EURJPY,9,22.869999999999997,1,8,0.8888888888888888
74935,EURUSD,49,115.9,10,39,0.7959183673469388
74935,GBPCHF,10,-587.27,6,4,0.4
74935,GBPJPY,27,-60.129999999999995,9,18,0.6666666666666666
74935,GBPUSD,146,-292.7,36,110,0.7534246575342466
74935,NZDUSD,3,-38.3,3,0,0.0
74935,USDCAD,3,61.58,0,3,1.0
74935,USDCHF,20,24.16,4,16,0.8
74935,USDJPY,15,4.169999999999999,4,11,0.7333333333333333
75126,AUDUSD,9,-116.3,7,2,0.2222222222222222
75126,CADJPY,1,-312.47,1,0,0.0
75126,EURAUD,1,11.41,0,1,1.0
75126,EURJPY,14,84.50999999999999,6,8,0.5714285714285714
75126,EURUSD,39,-2560.39,25,14,0.358974358974359
75126,GBPJPY,7,500.71999999999997,2,5,0.7142857142857143
75126,GBPUSD,54,-290.3,25,29,0.5370370370370371
75126,NZDUSD,8,-235.7,3,5,0.625
75126,USDCAD,13,-221.70000000000002,7,6,0.46153846153846156
75126,USDCHF,3,17.830000000000002,2,1,0.3333333333333333
75126,USDJPY,19,-629.98,15,4,0.21052631578947367
75126,XAGUSD,1,-21.0,1,0,0.0
75126,XAUUSD,1,-114.5,1,0,0.0
75211,EURJPY,94,-484.09000000000003,53,41,0.43617021276595747
75211,EURUSD,298,-591.52,181,117,0.3926174496644295
75549,EURUSD,2304,1421.8999999999983,467,1837,0.7973090277777778
75712,AUDUSD,58,297.3,17,41,0.7068965517241379
75712,EURCHF,18,-438.18,7,11,0.6111111111111112
75712,EURGBP,7,-195.26999999999998,5,2,0.2857142857142857
75712,EURJPY,5,-2.2299999999999978,3,2,0.4
75712,EURUSD,550,-3592.85,213,337,0.6127272727272727
75712,GBPJPY,8,-150.13,5,3,0.375
75712,GBPUSD,479,-2441.0,228,251,0.524008350730689
75712,NZDUSD,2,-1.7999999999999998,1,1,0.5
75712,USDCAD,22,-287.23,15,7,0.3181818181818182
75712,USDCHF,63,422.02,7,56,0.8888888888888888
75712,USDJPY,17,425.28999999999996,5,12,0.7058823529411765
75712,XAGUSD,1,2.0,0,1,1.0
75712,XAUUSD,310,-3132.9,122,188,0.6064516129032258
75772,GBPJPY,125,-540.3,72,53,0.424
75772,GBPUSD,12,-20.299999999999997,5,7,0.5833333333333334
75772,USDCAD,1,0.56,0,1,1.0
75772,USDJPY,1,2.45,0,1,1.0
75931,AUDCAD,12,-1088.53,6,6,0.5
75931,AUDJPY,16,-1417.46,8,8,0.5
75931,AUDNZD,15,-2002.83,10,5,0.3333333333333333
75931,AUDUSD,16,-47.60000000000002,9,7,0.4375
75931,CADJPY,15,673.14,3,12,0.8
75931,CHFJPY,11,-321.87,3,8,0.7272727272727273
75931,EURAUD,32,975.5800000000003,16,16,0.5
75931,EURCAD,18,1866.96,7,11,0.6111111111111112
75931,EURCHF,10,-257.56,6,4,0.4
75931,EURGBP,19,-1604.3400000000001,10,9,0.47368421052631576
75931,EURJPY,19,1760.26,5,14,0.7368421052631579
75931,EURUSD,18,827.0,6,12,0.6666666666666666
75931,GBPCHF,29,-4551.63,15,14,0.4827586206896552
75931,GBPJPY,44,1928.5299999999997,15,29,0.6590909090909091
75931,GBPUSD,20,-2777.0,11,9,0.45
75931,NZDUSD,6,-448.0,2,4,0.6666666666666666
75931,USDCAD,11,-242.55999999999997,5,6,0.5454545454545454
75931,USDCHF,17,-267.31,8,9,0.5294117647058824
75931,USDJPY,21,-2330.18,10,11,0.5238095238095238
75931,XAUUSD,4,23.700000000000003,1,3,0.75
77120,EURUSD,413,-264.81,182,231,0.559322033898305
77257,EURUSD,223,-1036.5,38,185,0.8295964125560538
77309,AUDJPY,2,3.4800000000000004,0,2,1.0
77309,AUDUSD,12,-373.0,8,4,0.3333333333333333
77309,CHFJPY,7,181.88,2,5,0.7142857142857143
77309,EURAUD,5,96.83000000000001,1,4,0.8
77309,EURCHF,9,112.58000000000001,3,6,0.6666666666666666
77309,EURGBP,18,-122.39999999999998,4,14,0.7777777777777778
77309,EURJPY,30,-753.36,10,20,0.6666666666666666
77309,EURUSD,107,164.4,46,61,0.5700934579439252
77309,GBPCHF,8,100.35,2,6,0.75
77309,GBPJPY,55,-1331.14,13,42,0.7636363636363637
77309,GBPUSD,187,854.5,43,144,0.7700534759358288
77309,NZDUSD,2,61.0,1,1,0.5
77309,USDCAD,12,-649.0799999999999,10,2,0.16666666666666666
77309,USDCHF,28,272.61,14,14,0.5
77309,USDJPY,13,-72.20999999999998,4,9,0.6923076923076923
77371,AUDUSD,3,67.15,0,3,1.0
77371,EURCHF,1,6.85,0,1,1.0
77371,EURJPY,34,5.429999999999996,14,20,0.5882352941176471
77371,EURUSD,4349,-10471.62,1898,2451,0.5635778339848241
77371,GBPJPY,10,-7.969999999999999,3,7,0.7
77371,GBPUSD,166,-1223.52,85,81,0.4879518072289157
77371,USDCAD,1,-7.76,1,0,0.0
77371,USDCHF,5,-53.46000000000001,3,2,0.4
77371,USDJPY,16,-8.759999999999998,4,12,0.75
77371,XAUUSD,2,-9.68,1,1,0.5
77551,AUDUSD,14,42.4,0,14,1.0
77551,CHFJPY,1,2.8,0,1,1.0
77551,EURCAD,1,2.27,0,1,1.0
77551,EURJPY,1,84.38,0,1,1.0
77551,EURUSD,366,-2986.6,135,231,0.6311475409836066
77551,GBPUSD,27,-2162.2,7,20,0.7407407407407407
77551,USDCAD,1,1.04,0,1,1.0
77551,USDCHF,12,-216.96,1,11,0.9166666666666666
77551,USDJPY,9,-367.0,3,6,0.6666666666666666
77650,EURUSD,67,-115.9,13,54,0.8059701492537313
77650,USDCHF,44,305.63,0,44,1.0
77821,AUDJPY,4,-12.169999999999998,4,0,0.0
77821,AUDUSD,30,-384.8,24,6,0.2
77821,EURAUD,22,-25.930000000000035,16,6,0.2727272727272727
77821,EURCAD,4,-73.55000000000001,3,1,0.25
77821,EURJPY,5,-6.18,3,2,0.4
77821,EURUSD,121,-348.14,63,58,0.4793388429752066
77821,GBPJPY,4,-100.67,3,1,0.25
77821,GBPUSD,17,-22.8,12,5,0.29411764705882354
77821,USDCAD,11,171.34,6,5,0.45454545454545453
77821,USDCHF,17,-115.25,12,5,0.29411764705882354
77821,USDJPY,1,18.18,0,1,1.0
77821,USDMXN,1,-2.24,1,0,0.0
77821,XAUUSD,1,-0.9,1,0,0.0
78087,AUDUSD,23,-53.59,17,6,0.2608695652173913
78087,CADJPY,2,0.22999999999999954,1,1,0.5
78087,EURAUD,10,12.109999999999996,7,3,0.3
78087,EURGBP,1,-7.44,1,0,0.0
78087,EURUSD,165,-189.68,103,62,0.37575757575757573
78087,GBPJPY,2,-11.030000000000001,2,0,0.0
78087,GBPUSD,31,-22.599999999999998,19,12,0.3870967741935484
78087,NZDUSD,1,6.6,0,1,1.0
78087,USDCAD,19,-5.93,10,9,0.47368421052631576
78087,USDJPY,10,-13.81,8,2,0.2
78809,AUDJPY,23,46.79000000000002,5,18,0.782608695652174
78809,AUDUSD,22,-30.6,8,14,0.6363636363636364
78809,CHFJPY,1,0.56,0,1,1.0
78809,EURCAD,2,-117.74000000000001,2,0,0.0
78809,EURCHF,1,-14.97,1,0,0.0
78809,EURGBP,4,-3.800000000000001,2,2,0.5
78809,EURJPY,121,324.3100000000001,47,74,0.6115702479338843
78809,EURUSD,1039,-1787.7,331,708,0.6814244465832531
78809,GBPCHF,3,-94.0,2,1,0.3333333333333333
78809,GBPJPY,284,-4076.33,152,132,0.4647887323943662
78809,GBPUSD,180,1888.0,86,94,0.5222222222222223
78809,USDCAD,1,-180.16,1,0,0.0
78809,USDCHF,40,53.690000000000005,16,24,0.6
78809,USDJPY,33,-77.9,17,16,0.48484848484848486
79710,AUDJPY,1,-3.1,1,0,0.0
79710,AUDUSD,2,19.05,0,2,1.0
79710,EURCHF,2,-12.030000000000001,1,1,0.5
79710,EURGBP,1,11.0,0,1,1.0
79710,EURJPY,3,2.830000000000002,1,2,0.6666666666666666
79710,EURUSD,160,-16617.79,37,123,0.76875
79710,GBPCHF,2,1.58,1,1,0.5
79710,GBPJPY,94,1549.8799999999999,14,80,0.851063829787234
79710,GBPUSD,2,1.1100000000000003,1,1,0.5
79710,NZDUSD,2,10.719999999999999,0,2,1.0
79710,USDCAD,1,33.18,0,1,1.0
79710,USDJPY,9,501.02,1,8,0.8888888888888888
79741,AUDUSD,1,10.0,0,1,1.0
79741,EURJPY,3,102.61999999999998,2,1,0.3333333333333333
79741,EURUSD,95,219.74,48,47,0.49473684210526314
79741,GBPUSD,30,729.0,10,20,0.6666666666666666
79741,USDJPY,24,-766.6399999999999,13,11,0.4583333333333333
79832,AUDJPY,19,-118.67,14,5,0.2631578947368421
79832,AUDUSD,189,-1610.0,105,84,0.4444444444444444
79832,EURGBP,9,-251.39,6,3,0.3333333333333333
79832,EURUSD,263,-2795.42,130,133,0.5057034220532319
79832,GBPUSD,30,-552.64,21,9,0.3
79832,NZDUSD,48,-101.92,27,21,0.4375
79832,USDCAD,25,-71.4,14,11,0.44
79832,USDCHF,11,165.02,3,8,0.7272727272727273
79832,USDJPY,6,-265.26,5,1,0.16666666666666666
79838,AUDUSD,16,-53.1,11,5,0.3125
79838,CHFJPY,2,-2.25,2,0,0.0
79838,EURCHF,31,-185.55,22,9,0.2903225806451613
79838,EURGBP,3,-81.87,2,1,0.3333333333333333
79838,EURUSD,13402,-20651.5,5521,7881,0.5880465602148933
79838,GBPJPY,28,18.560000000000002,15,13,0.4642857142857143
79838,GBPUSD,86,-266.0,35,51,0.5930232558139535
79838,NZDUSD,1,-12.55,1,0,0.0
79838,USDCAD,3,-25.14,2,1,0.3333333333333333
79838,USDCHF,128,-494.56,77,51,0.3984375
79838,USDJPY,12,-62.04,9,3,0.25
79838,XAUUSD,1,-0.6,1,0,0.0
79873,AUDCAD,28,322.46,14,14,0.5
79873,AUDJPY,18,-39.529999999999994,10,8,0.4444444444444444
79873,AUDNZD,19,119.14,5,14,0.7368421052631579
79873,AUDUSD,19,-82.04,8,11,0.5789473684210527
79873,CADJPY,11,-78.1,8,3,0.2727272727272727
79873,CHFJPY,13,10.189999999999994,8,5,0.38461538461538464
79873,EURAUD,18,-821.0699999999999,11,7,0.3888888888888889
79873,EURCAD,35,195.36,13,22,0.6285714285714286
79873,EURCHF,22,-604.0,12,10,0.45454545454545453
79873,EURGBP,18,-125.56000000000002,8,10,0.5555555555555556
79873,EURJPY,25,749.65,7,18,0.72
79873,EURUSD,295,-544.3299999999992,138,157,0.5322033898305085
79873,GBPCHF,12,-8.359999999999996,5,7,0.5833333333333334
79873,GBPJPY,15,-570.47,12,3,0.2
79873,GBPUSD,34,5.02000000000001,15,19,0.5588235294117647
79873,NZDUSD,36,307.65000000000003,19,17,0.4722222222222222
79873,USDCAD,20,-76.35000000000001,11,9,0.45
79873,USDCHF,16,-30.750000000000007,3,13,0.8125
79873,USDJPY,38,-286.17,21,17,0.4473684210526316
79900,AUDCAD,1,-43.21,1,0,0.0
79900,AUDJPY,18,327.62,14,4,0.2222222222222222
79900,AUDUSD,19,-43.6,15,4,0.21052631578947367
79900,CHFJPY,3,9.189999999999998,2,1,0.3333333333333333
79900,EURAUD,51,-84.21000000000001,36,15,0.29411764705882354
79900,EURCAD,28,-82.02000000000001,19,9,0.32142857142857145
79900,EURCHF,22,51.72999999999999,13,9,0.4090909090909091
79900,EURJPY,44,-44.18,27,17,0.38636363636363635
79900,EURUSD,509,125.06,289,220,0.43222003929273084
79900,GBPCHF,80,-596.5,49,31,0.3875
79900,GBPJPY,138,-751.65,85,53,0.38405797101449274
79900,GBPUSD,299,376.34000000000003,196,103,0.34448160535117056
79900,NZDUSD,4,10.100000000000001,2,2,0.5
79900,USDCAD,83,-122.51,55,28,0.3373493975903614
79900,USDCHF,77,-88.67000000000002,58,19,0.24675324675324675
79900,USDJPY,55,-622.4200000000001,33,22,0.4
79900,XAGUSD,35,-151.32,22,13,0.37142857142857144
79900,XAUUSD,117,776.46,60,57,0.48717948717948717
79926,AUDJPY,3,-3.5400000000000005,1,2,0.6666666666666666
79926,AUDUSD,6,-37.5,5,1,0.16666666666666666
79926,EURJPY,15,51.48000000000001,7,8,0.5333333333333333
79926,EURUSD,262,-870.0,142,120,0.4580152671755725
79926,GBPJPY,3,-9.989999999999998,2,1,0.3333333333333333
79926,GBPUSD,97,16.9,57,40,0.41237113402061853
79926,USDCAD,6,-22.86,2,4,0.6666666666666666
79926,USDCHF,8,7.9999999999999964,3,5,0.625
79926,USDJPY,1,5.4,0,1,1.0
79926,XAGUSD,1,6.0,0,1,1.0
79926,XAUUSD,1,2.5,0,1,1.0
82780,AUDJPY,86,-9.259999999999998,11,75,0.872093023255814
82780,AUDUSD,203,-45.1,33,170,0.8374384236453202
82780,EURGBP,1,0.2,0,1,1.0
82780,EURJPY,231,20.780000000000005,24,207,0.8961038961038961
82780,EURUSD,2966,-788.2,207,2759,0.9302090357383682
82780,GBPJPY,569,-526.51,94,475,0.8347978910369068
82780,GBPUSD,1347,364.09999999999997,102,1245,0.9242761692650334
82780,NZDUSD,49,21.0,3,46,0.9387755102040817
82780,USDCAD,5,1.4000000000000001,0,5,1.0
82780,USDCHF,1,0.17,0,1,1.0
82780,USDJPY,261,-212.16,37,224,0.8582375478927203
82780,XAGUSD,2,-1.2,2,0,0.0
84990,AUDUSD,5,-75.3,3,2,0.4
84990,EURCHF,7,192.62,2,5,0.7142857142857143
84990,EURGBP,1,0.39,0,1,1.0
84990,EURJPY,10,-199.4,7,3,0.3
84990,EURUSD,80,-240.5,15,65,0.8125
84990,GBPJPY,2,-5.4799999999999995,1,1,0.5
84990,GBPUSD,8,-178.4,3,5,0.625
84990,USDCHF,6,182.11,1,5,0.8333333333333334
84990,USDJPY,39,-140.61,8,31,0.7948717948717948
88489,AUDJPY,2,21.990000000000002,0,2,1.0
88489,AUDUSD,33,-1896.2,3,30,0.9090909090909091
88489,CADJPY,29,115.41999999999996,1,28,0.9655172413793104
88489,CHFJPY,3,35.980000000000004,0,3,1.0
88489,EURAUD,53,766.47,0,53,1.0
88489,EURCHF,79,642.11,0,79,1.0
88489,EURGBP,12,-263.86,1,11,0.9166666666666666
88489,EURUSD,296,-5866.32,38,258,0.8716216216216216
88489,GBPJPY,1,8.16,0,1,1.0
88489,GBPUSD,61,591.07,1,60,0.9836065573770492
88489,NZDUSD,29,-2188.29,5,24,0.8275862068965517
88489,USDCAD,2,17.06,0,2,1.0
88489,USDCHF,32,71.93,2,30,0.9375
88489,USDJPY,26,310.08,0,26,1.0
88489,XAGUSD,2,-262.5,2,0,0.0
88489,XAUUSD,139,-7658.61,28,111,0.7985611510791367
95009,AUDUSD,91,958.8,36,55,0.6043956043956044
95009,EURCAD,1,0.0,1,0,0.0
95009,EURCHF,4,-34.73,2,2,0.5
95009,EURJPY,1,0.22,0,1,1.0
95009,EURUSD,250,-4422.1,133,117,0.468
95009,GBPJPY,2,7.23,1,1,0.5
95009,GBPUSD,1082,10714.1,402,680,0.6284658040665434
95009,NZDUSD,1,1.0,0,1,1.0
95009,USDCAD,151,-4079.14,46,105,0.695364238410596
95009,USDCHF,11,118.63,4,7,0.6363636363636364
95009,USDJPY,36,540.43,15,21,0.5833333333333334
95009,XAUUSD,45,-12649.23,30,15,0.3333333333333333
95051,AUDUSD,6,52.19999999999999,1,5,0.8333333333333334
95051,EURCAD,4,109.59,1,3,0.75
95051,EURJPY,6,560.4000000000001,2,4,0.6666666666666666
95051,EURUSD,13,-1449.54,9,4,0.3076923076923077
95051,GBPJPY,91,188.29000000000005,40,51,0.5604395604395604
95051,GBPUSD,12,343.0,6,6,0.5
95051,NZDUSD,1,120.0,0,1,1.0
95051,USDCAD,5,-346.84,4,1,0.2
95051,USDCHF,31,229.32000000000005,11,20,0.6451612903225806
95051,USDJPY,1,4.39,0,1,1.0
95065,AUDCAD,2,-8.89,2,0,0.0
95065,AUDJPY,34,-199.43,29,5,0.14705882352941177
95065,AUDNZD,2,-9.06,2,0,0.0
95065,AUDUSD,32,-0.600000000000005,20,12,0.375
95065,CADJPY,6,-14.76,5,1,0.16666666666666666
95065,EURAUD,1,5.57,0,1,1.0
95065,EURGBP,16,-33.03999999999999,11,5,0.3125
95065,EURJPY,1,-2.33,1,0,0.0
95065,EURUSD,89,-103.32,56,33,0.3707865168539326
95065,GBPJPY,12,-41.11,5,7,0.5833333333333334
95065,GBPUSD,3,-0.19999999999999996,1,2,0.6666666666666666
95065,USDCAD,1,-10.59,1,0,0.0
95065,USDCHF,8,-65.23,8,0,0.0
95065,USDJPY,136,-158.67,93,43,0.3161764705882353
95065,XAGUSD,1,13.93,0,1,1.0
95065,XAUUSD,58,-28.459999999999994,36,22,0.3793103448275862
95077,AUDCAD,1,20.8,0,1,1.0
95077,AUDJPY,1,-3.52,1,0,0.0
95077,AUDUSD,27,18.53,13,14,0.5185185185185185
95077,EURCHF,3,20.02,1,2,0.6666666666666666
95077,EURGBP,5,31.61,3,2,0.4
95077,EURJPY,42,4.530000000000001,17,25,0.5952380952380952
95077,EURUSD,632,-609.28,326,306,0.48417721518987344
95077,GBPCHF,1,-16.43,1,0,0.0
95077,GBPJPY,5,-16.83,4,1,0.2
95077,GBPUSD,54,-22.9,32,22,0.4074074074074074
95077,NZDUSD,2,28.8,0,2,1.0
95077,USDCAD,6,-16.759999999999998,6,0,0.0
95077,USDCHF,19,-6.519999999999999,8,11,0.5789473684210527
95077,USDJPY,11,-42.63999999999999,9,2,0.18181818181818182
95077,XAUUSD,3,-4.93,3,0,0.0
97414,AUDUSD,24,-358.90000000000003,17,7,0.2916666666666667
97414,EURUSD,20,67.31999999999988,12,8,0.4
97414,GBPJPY,24,-869.72,17,7,0.2916666666666667
97414,GBPUSD,19,-289.71999999999997,12,7,0.3684210526315789
97414,NZDUSD,20,-161.5299999999999,13,7,0.35
97414,USDCAD,27,-1746.55,21,6,0.2222222222222222
97414,USDCHF,19,139.72000000000008,10,9,0.47368421052631576
97414,USDJPY,25,-1641.27,20,5,0.2
97647,AUDJPY,1,-32.44,1,0,0.0
97647,EURUSD,9,-233.0,6,3,0.3333333333333333
97647,GBPUSD,223,-8413.0,136,87,0.3901345291479821
97647,USDCHF,4,-86.58,4,0,0.0
97647,USDJPY,6,-251.97,5,1,0.16666666666666666
97735,AUDJPY,3,30.499999999999993,1,2,0.6666666666666666
97735,AUDUSD,2,-44.83,2,0,0.0
97735,CADJPY,2,19.34,0,2,1.0
97735,CHFJPY,2,-37.370000000000005,2,0,0.0
97735,EURGBP,2,25.6,1,1,0.5
97735,EURJPY,2,36.28,0,2,1.0
97735,EURUSD,229,-2034.4,129,100,0.4366812227074236
97735,GBPCHF,1,0.0,1,0,0.0
97735,GBPJPY,46,-437.83000000000004,21,25,0.5434782608695652
97735,GBPUSD,22,90.5,11,11,0.5
97735,NZDUSD,1,-40.0,1,0,0.0
97735,USDCAD,1,7.14,0,1,1.0
97735,USDCHF,1,-6.37,1,0,0.0
97735,USDJPY,3,20.65,1,2,0.6666666666666666
97735,XAUUSD,32,1783.38,1,31,0.96875
97744,AUDJPY,1,4.39,0,1,1.0
97744,AUDUSD,96,-4110.3,16,80,0.8333333333333334
97744,EURAUD,29,1278.6000000000001,4,25,0.8620689655172413
97744,EURJPY,92,4901.97,13,79,0.8586956521739131
97744,EURUSD,122,-4029.2,23,99,0.8114754098360656
97744,GBPUSD,30,256.0,2,28,0.9333333333333333
97744,NZDUSD,1,-2654.0,1,0,0.0
97744,USDJPY,49,34.44000000000001,11,38,0.7755102040816326
97744,XAUUSD,121,2971.7,23,98,0.8099173553719008
97771,AUDUSD,106,-10.6,30,76,0.7169811320754716
97771,EURGBP,9,-3.7700000000000005,4,5,0.5555555555555556
97771,EURJPY,19,-1.4100000000000001,7,12,0.631578947368421
97771,EURUSD,2070,801.3,636,1434,0.6927536231884058
97786,EURCHF,6,-695.33,5,1,0.16666666666666666
97786,EURJPY,134,-1087.96,65,69,0.5149253731343284
97786,EURUSD,2264,-10557.6,666,1598,0.7058303886925795
97786,GBPJPY,90,-189.03000000000003,45,45,0.5
97786,GBPUSD,147,-381.3,58,89,0.6054421768707483
97786,USDCAD,2,-48.16,2,0,0.0
97786,USDJPY,1,0.0,1,0,0.0
97818,EURCHF,6,-391.36,5,1,0.16666666666666666
97818,EURGBP,1,15.68,0,1,1.0
97818,EURJPY,2,60.970000000000006,0,2,1.0
97818,EURUSD,113,-539.91,25,88,0.7787610619469026
97818,GBPUSD,6,-74.14,3,3,0.5
97818,USDCAD,3,14.94,0,3,1.0
97818,USDJPY,2,6.17,0,2,1.0
97944,AUDUSD,60,-54.95,23,37,0.6166666666666667
97944,EURAUD,3,-14.0,2,1,0.3333333333333333
97944,EURCAD,2,2.59,1,1,0.5
97944,EURCHF,8,5.7,1,7,0.875
97944,EURGBP,16,-38.37,8,8,0.5
97944,EURJPY,10,-70.55,5,5,0.5
97944,EURUSD,209,-1137.33,89,120,0.5741626794258373
97944,GBPCHF,1,0.18,0,1,1.0
97944,GBPJPY,470,-464.3399999999999,195,275,0.5851063829787234
97944,GBPUSD,165,-494.81,75,90,0.5454545454545454
97944,NZDUSD,9,5.800000000000001,2,7,0.7777777777777778
97944,USDCAD,19,-42.93,7,12,0.631578947368421
97944,USDCHF,40,-56.46,17,23,0.575
97944,USDJPY,50,-70.92,25,25,0.5
97944,XAGUSD,3,-0.9,3,0,0.0
97944,XAUUSD,3,1.52,2,1,0.3333333333333333
97974,AUDCAD,7,2.88,0,7,1.0
97974,AUDUSD,121,-28.0,20,101,0.8347107438016529
97974,EURCAD,58,-71.72,14,44,0.7586206896551724
97974,EURCHF,158,78.46,47,111,0.7025316455696202
97974,EURGBP,22,-1.7200000000000024,2,20,0.9090909090909091
97974,EURJPY,393,205.95,42,351,0.8931297709923665
97974,EURUSD,335,-600.8,56,279,0.8328358208955224
97974,GBPUSD,219,170.0,39,180,0.821917808219178
97974,USDCAD,5,29.43,0,5,1.0
97974,USDCHF,158,-66.74000000000001,13,145,0.9177215189873418
97974,USDJPY,41,-107.87,10,31,0.7560975609756098
98172,AUDUSD,2,-32.0,2,0,0.0
98172,EURJPY,8,-35.739999999999995,3,5,0.625
98172,EURUSD,263,-1498.9,129,134,0.5095057034220533
98172,GBPUSD,105,-67.9,46,59,0.5619047619047619
98172,USDCHF,4,-34.78,2,2,0.5
98172,USDJPY,33,-201.64,17,16,0.48484848484848486
98172,XAUUSD,1,-1.5,1,0,0.0
98533,CHFJPY,1,-1.23,1,0,0.0
98533,EURJPY,1,0.11,0,1,1.0
98533,EURUSD,41,-42.49,10,31,0.7560975609756098
98533,GBPJPY,8,-1.7500000000000036,4,4,0.5
98533,GBPUSD,2,-25.7,1,1,0.5
98533,NZDUSD,1,-1.7,1,0,0.0
98533,USDCAD,15,-28.34,6,9,0.6
98533,USDCHF,44,-66.39,15,29,0.6590909090909091
98533,USDJPY,72,-31.169999999999998,24,48,0.6666666666666666
99155,EURUSD,4,-86.0,2,2,0.5
99155,GBPUSD,137,-1147.7,52,85,0.6204379562043796
99224,AUDJPY,1,1.07,0,1,1.0
99224,EURGBP,49,-1076.47,21,28,0.5714285714285714
99224,EURJPY,7,-118.07,5,2,0.2857142857142857
99224,EURUSD,24,38.900000000000006,12,12,0.5
99224,GBPJPY,81,-1344.85,42,39,0.48148148148148145
99224,GBPUSD,22,-131.4,10,12,0.5454545454545454
99224,USDCAD,4,-7.9,2,2,0.5
99224,USDCHF,4,5.8999999999999995,1,3,0.75
99224,USDJPY,10,-21.79,6,4,0.4
99256,AUDUSD,261,-179.2,157,104,0.39846743295019155
99256,EURJPY,87,-62.980000000000004,52,35,0.40229885057471265
99256,EURUSD,136,-0.1000000000000002,73,63,0.4632352941176471
99256,GBPJPY,16,-6.259999999999998,11,5,0.3125
99256,GBPUSD,13,-24.3,8,5,0.38461538461538464
99256,NZDUSD,42,-10.5,23,19,0.4523809523809524
99256,USDCAD,12,22.02,3,9,0.75
99256,USDCHF,13,-19.34,9,4,0.3076923076923077
99256,USDJPY,48,6.239999999999998,24,24,0.5
99480,AUDCAD,13,-615.78,8,5,0.38461538461538464
99480,AUDJPY,11,-88.48,7,4,0.36363636363636365
99480,AUDNZD,4,-8.95,1,3,0.75
99480,AUDUSD,11,108.03,3,8,0.7272727272727273
99480,CADJPY,20,-511.45,8,12,0.6
99480,CHFJPY,8,13.499999999999998,3,5,0.625
99480,EURAUD,9,301.26,3,6,0.6666666666666666
99480,EURCAD,2,-32.04,2,0,0.0
99480,EURCHF,17,-87.39999999999999,14,3,0.17647058823529413
99480,EURGBP,33,1501.2,11,22,0.6666666666666666
99480,EURJPY,23,-580.33,14,9,0.391304347826087
99480,EURUSD,46,-335.51,28,18,0.391304347826087
99480,GBPCHF,5,-30.7,3,2,0.4
99480,GBPJPY,21,-393.46,9,12,0.5714285714285714
99480,GBPUSD,42,-86.75,22,20,0.47619047619047616
99480,NZDUSD,8,23.8,4,4,0.5
99480,USDCAD,16,-246.51,10,6,0.375
99480,USDCHF,18,-16.33,8,10,0.5555555555555556
99480,USDJPY,17,-212.16000000000003,7,10,0.5882352941176471
99480,XAGUSD,50,-332.12,20,30,0.6
99480,XAUUSD,174,-200.8000000000001,53,121,0.6954022988505747
99485,AUDCAD,26,44.62,13,13,0.5
99485,AUDJPY,18,-178.82,13,5,0.2777777777777778
99485,AUDNZD,12,-55.36,8,4,0.3333333333333333
99485,AUDUSD,38,-69.01,23,15,0.39473684210526316
99485,CADJPY,7,-61.879999999999995,4,3,0.42857142857142855
99485,CHFJPY,36,-216.46,17,19,0.5277777777777778
99485,EURAUD,24,-5.8599999999999834,11,13,0.5416666666666666
99485,EURCAD,39,127.88000000000001,16,23,0.5897435897435898
99485,EURCHF,7,-19.14,6,1,0.14285714285714285
99485,EURGBP,36,-25.540000000000006,16,20,0.5555555555555556
99485,EURJPY,40,255.49,15,25,0.625
99485,EURUSD,46,-2.7399999999999993,23,23,0.5
99485,GBPCHF,17,-61.42,12,5,0.29411764705882354
99485,GBPJPY,21,-77.54,17,4,0.19047619047619047
99485,GBPUSD,49,-68.15,27,22,0.4489795918367347
99485,NZDUSD,17,-39.79,8,9,0.5294117647058824
99485,USDCAD,46,-120.21,28,18,0.391304347826087
99485,USDCHF,36,-151.16,17,19,0.5277777777777778
99485,USDJPY,38,-208.9,26,12,0.3157894736842105
99485,XAGUSD,1,-9.2,1,0,0.0
99485,XAUUSD,3,-42.34,3,0,0.0
99740,AUDUSD,81,-143.98000000000002,16,65,0.8024691358024691
99740,EURGBP,16,-297.73,6,10,0.625
99740,EURJPY,145,-786.6499999999999,43,102,0.7034482758620689
99740,EURUSD,1416,-6085.7,362,1054,0.7443502824858758
99740,USDJPY,220,-331.80999999999995,64,156,0.7090909090909091
99890,AUDCAD,1,0.0,1,0,0.0
99890,AUDJPY,1,0.2,0,1,1.0
99890,AUDUSD,55,-73.63,32,23,0.41818181818181815
99890,CADJPY,2,2.52,0,2,1.0
99890,EURCAD,1,3.89,0,1,1.0
99890,EURCHF,5,-84.74000000000001,5,0,0.0
99890,EURGBP,19,-453.7,12,7,0.3684210526315789
99890,EURJPY,95,-58.620000000000005,42,53,0.5578947368421052
99890,EURUSD,162,-71.83,88,74,0.4567901234567901
99890,GBPJPY,208,-1341.44,96,112,0.5384615384615384
99890,GBPUSD,81,-74.39,46,35,0.43209876543209874
99890,NZDUSD,31,-1.6099999999999994,14,17,0.5483870967741935
99890,USDCAD,76,-188.39,35,41,0.5394736842105263
99890,USDCHF,53,-11.809999999999999,26,27,0.5094339622641509
99890,USDJPY,106,381.37,54,52,0.49056603773584906
120446,EURUSD,219,-61200.0,158,61,0.2785388127853881
120446,USDCHF,1,-532.2,1,0,0.0
120583,AUDJPY,4,-6.67,3,1,0.25
120583,AUDUSD,1,0.3,0,1,1.0
120583,CADJPY,1,-0.45,1,0,0.0
120583,EURGBP,6,-34.59,4,2,0.3333333333333333
120583,EURJPY,26,309.35,5,21,0.8076923076923077
120583,EURUSD,242,-224.79999999999998,63,179,0.7396694214876033
120583,GBPJPY,79,-116.75999999999999,16,63,0.7974683544303798
120583,GBPUSD,62,-40.400000000000006,15,47,0.7580645161290323
120583,USDCAD,11,-33.36,7,4,0.36363636363636365
120583,XAUUSD,3,0.75,1,2,0.6666666666666666
120594,AUDJPY,1,1.57,0,1,1.0
120594,AUDUSD,3,3.9000000000000004,1,2,0.6666666666666666
120594,CADJPY,5,-21.870000000000005,3,2,0.4
120594,CHFJPY,1,-2.51,1,0,0.0
120594,EURAUD,1,-21.42,1,0,0.0
120594,EURCHF,1,-9.51,1,0,0.0
120594,EURGBP,3,-337.84000000000003,2,1,0.3333333333333333
120594,EURJPY,13,-47.16,6,7,0.5384615384615384
120594,EURUSD,67,-228.0,21,46,0.6865671641791045
120594,GBPJPY,5,-130.88,5,0,0.0
120594,GBPUSD,47,-153.3,22,25,0.5319148936170213
120594,USDCAD,5,-50.54,4,1,0.2
120594,USDCHF,3,7.470000000000001,1,2,0.6666666666666666
120594,USDJPY,22,-128.47,11,11,0.5
120799,AUDNZD,1,0.61,0,1,1.0
120799,AUDUSD,77,-40.019999999999996,47,30,0.38961038961038963
120799,EURCAD,2,2.9,1,1,0.5
120799,EURCHF,4,6.51,2,2,0.5
120799,EURJPY,54,74.82000000000002,31,23,0.42592592592592593
120799,EURUSD,265,-876.64,150,115,0.4339622641509434
120799,GBPJPY,123,-1331.21,67,56,0.45528455284552843
120799,GBPUSD,566,-129.66000000000005,320,246,0.43462897526501765
120799,NZDUSD,18,-46.1,10,8,0.4444444444444444
120799,USDCAD,80,-196.08999999999997,49,31,0.3875
120799,USDCHF,94,11.65999999999998,51,43,0.4574468085106383
120799,USDJPY,101,-490.59999999999997,56,45,0.44554455445544555
120862,EURCHF,1,0.09,0,1,1.0
120862,EURUSD,4,9.85,1,3,0.75
120862,GBPUSD,354,717.76,61,293,0.827683615819209
120873,EURUSD,82,-179.95,38,44,0.5365853658536586
120873,GBPUSD,20,-71.7,11,9,0.45
121379,AUDUSD,14,-19.0,2,12,0.8571428571428571
121379,EURCHF,2,11.959999999999999,0,2,1.0
121379,EURGBP,3,9.030000000000001,0,3,1.0
121379,EURJPY,2,79.55000000000001,0,2,1.0
121379,EURUSD,256,-1679.3,23,233,0.91015625
121379,GBPJPY,11,-463.29,2,9,0.8181818181818182
121379,GBPUSD,181,-11391.9,23,158,0.8729281767955801
121379,NZDUSD,1,-15.0,1,0,0.0
121379,XAUUSD,7,17.34,0,7,1.0
121525,AUDJPY,1,-13.08,1,0,0.0
121525,EURUSD,17,-108.39999999999999,8,9,0.5294117647058824
121525,GBPJPY,12,175.52,2,10,0.8333333333333334
121525,GBPUSD,93,-151.5,36,57,0.6129032258064516
121750,EURUSD,624,-11013.1,122,502,0.8044871794871795
121750,GBPUSD,3,6.2,0,3,1.0
121750,USDJPY,2,-102.8,2,0,0.0
121766,AUDJPY,1,2.06,0,1,1.0
121766,AUDUSD,21,-895.0,5,16,0.7619047619047619
121766,EURCHF,2,96.99000000000001,0,2,1.0
121766,EURGBP,12,-578.2800000000001,3,9,0.75
121766,EURJPY,11,470.49,2,9,0.8181818181818182
121766,EURUSD,165,-2068.0,31,134,0.8121212121212121
121766,GBPJPY,2,-8977.99,2,0,0.0
121766,GBPUSD,57,-6822.0,17,40,0.7017543859649122
121766,NZDUSD,4,-1050.0,3,1,0.25
121766,USDCAD,20,-1370.83,6,14,0.7
121766,USDCHF,18,-1517.49,6,12,0.6666666666666666
121766,USDJPY,15,-603.69,4,11,0.7333333333333333
122026,AUDUSD,15,-779.0,5,10,0.6666666666666666
122026,CHFJPY,1,-5.81,1,0,0.0
122026,EURGBP,40,-325.56,11,29,0.725
122026,EURJPY,122,-2281.28,56,66,0.5409836065573771
122026,EURUSD,57,-2075.06,20,37,0.6491228070175439
122026,GBPJPY,158,-7948.929999999999,79,79,0.5
122026,GBPUSD,56,-1709.6399999999999,25,31,0.5535714285714286
122026,NZDUSD,10,-972.3,6,4,0.4
122026,USDCAD,120,-696.3,43,77,0.6416666666666667
122026,USDCHF,65,155.7899999999999,21,44,0.676923076923077
122026,USDJPY,86,-1179.1799999999998,40,46,0.5348837209302325
122092,AUDJPY,17,-4.349999999999969,9,8,0.47058823529411764
122092,AUDUSD,9,86.39999999999999,5,4,0.4444444444444444
122092,EURUSD,9,-27.2,6,3,0.3333333333333333
122092,GBPJPY,577,-669.2999999999997,252,325,0.5632582322357019
122092,GBPUSD,7,-513.3000000000001,4,3,0.42857142857142855
122092,USDCAD,3,-59.480000000000004,1,2,0.6666666666666666
122092,USDJPY,7,-180.15,5,2,0.2857142857142857
122203,AUDCAD,9,-18.18,6,3,0.3333333333333333
122203,AUDJPY,19,-19.32,9,10,0.5263157894736842
122203,AUDNZD,50,-191.22,39,11,0.22
122203,AUDUSD,25,-135.4,21,4,0.16
122203,CADJPY,4,3.75,1,3,0.75
122203,EURAUD,23,5.680000000000003,16,7,0.30434782608695654
122203,EURCAD,8,-32.25,6,2,0.25
122203,EURCHF,10,-11.72,6,4,0.4
122203,EURGBP,15,11.51,6,9,0.6
122203,EURJPY,58,-58.879999999999995,39,19,0.3275862068965517
122203,EURUSD,86,-183.62,43,43,0.5
122203,GBPCHF,12,-55.91,6,6,0.5
122203,GBPJPY,19,-355.72999999999996,9,10,0.5263157894736842
122203,GBPUSD,35,-613.1,17,18,0.5142857142857142
122203,USDCAD,26,-11.199999999999998,18,8,0.3076923076923077
122203,USDCHF,24,-52.629999999999995,13,11,0.4583333333333333
122203,USDJPY,29,27.910000000000004,14,15,0.5172413793103449
122288,AUDCAD,2,-3.13,1,1,0.5
122288,AUDNZD,165,-36.94999999999999,76,89,0.5393939393939394
122288,CADJPY,1,-10.21,1,0,0.0
122288,EURUSD,43,130.33,14,29,0.6744186046511628
122288,GBPJPY,2,-6.040000000000001,1,1,0.5
122288,GBPUSD,21,-28.53,9,12,0.5714285714285714
122288,USDJPY,48,-402.90999999999997,25,23,0.4791666666666667
122321,AUDJPY,4,-13.64,3,1,0.25
122321,CADJPY,5,-5.630000000000003,3,2,0.4
122321,EURCHF,5,11.219999999999999,2,3,0.6
122321,EURGBP,14,-93.11000000000001,9,5,0.35714285714285715
122321,EURJPY,1,-9.53,1,0,0.0
122321,EURUSD,2645,-13527.820000000002,1836,809,0.3058601134215501
122321,GBPJPY,9,-38.39,5,4,0.4444444444444444
122321,GBPUSD,15,-298.45,10,5,0.3333333333333333
122321,USDCHF,23,-17.399999999999995,14,9,0.391304347826087
122321,USDJPY,7,205.39,1,6,0.8571428571428571
122321,USDMXN,7,-9.09,6,1,0.14285714285714285
122321,USDTRY,7,46.949999999999996,3,4,0.5714285714285714
122321,XAGUSD,4,-65.9,4,0,0.0
122321,XAUUSD,4,61.11,2,2,0.5
123248,AUDJPY,1,-167.93,1,0,0.0
123248,AUDUSD,17,-183.0,10,7,0.4117647058823529
123248,EURCAD,3,46.400000000000006,2,1,0.3333333333333333
123248,EURCHF,3,-108.97,2,1,0.3333333333333333
123248,EURJPY,1,0.0,1,0,0.0
123248,EURUSD,139,-1205.4,92,47,0.3381294964028777
123248,GBPJPY,1,101.77,0,1,1.0
123248,GBPUSD,194,38.8,124,70,0.36082474226804123
123248,NZDUSD,2,-73.0,1,1,0.5
123248,USDCAD,9,-269.95,5,4,0.4444444444444444
123248,USDCHF,4,13.0,2,2,0.5
123248,USDJPY,2,-9.74,2,0,0.0
123248,XAGUSD,1,-45.0,1,0,0.0
123248,XAUUSD,1,40.5,0,1,1.0
123506,AUDJPY,6,86.97,0,6,1.0
123506,CADJPY,3,-5.36,3,0,0.0
123506,CHFJPY,8,78.21000000000001,1,7,0.875
123506,EURCAD,9,53.589999999999996,2,7,0.7777777777777778
123506,EURGBP,3,64.4,0,3,1.0
123506,EURJPY,2,33.63,0,2,1.0
123506,EURUSD,254,-549.3000000000001,93,161,0.6338582677165354
123506,GBPCHF,4,62.82,0,4,1.0
123506,GBPJPY,144,-2648.89,62,82,0.5694444444444444
123506,GBPUSD,1,8.7,0,1,1.0
123506,USDJPY,3,18.630000000000003,2,1,0.3333333333333333
123544,AUDUSD,3,-61.0,2,1,0.3333333333333333
123544,EURAUD,2,-73.64,2,0,0.0
123544,EURCHF,4,-54.739999999999995,2,2,0.5
123544,EURGBP,22,-153.14,10,12,0.5454545454545454
123544,EURJPY,3,31.86,0,3,1.0
123544,EURUSD,210,-700.32,89,121,0.5761904761904761
123544,GBPJPY,110,-968.54,53,57,0.5181818181818182
123544,GBPUSD,154,-684.72,59,95,0.6168831168831169
123544,USDCHF,1,20.25,0,1,1.0
123544,USDJPY,1,40.49,0,1,1.0
123763,AUDJPY,1,57.05,0,1,1.0
123763,AUDNZD,1,7.4,0,1,1.0
123763,AUDUSD,7,-114.0,3,4,0.5714285714285714
123763,CHFJPY,2,-115.36,2,0,0.0
123763,EURAUD,101,1101.5900000000001,31,70,0.693069306930693
123763,EURCHF,1,49.66,0,1,1.0
123763,EURGBP,6,167.45,1,5,0.8333333333333334
123763,EURJPY,7,-42.36,3,4,0.5714285714285714
123763,EURUSD,30,-3306.5,12,18,0.6
123763,GBPJPY,4,-364.74,3,1,0.25
123763,GBPUSD,28,-21410.1,11,17,0.6071428571428571
123763,NZDUSD,4,-78.0,3,1,0.25
123763,USDCHF,4,-293.43,3,1,0.25
123763,USDJPY,12,-289.11,4,8,0.6666666666666666
124099,EURUSD,506,-4856.4,310,196,0.38735177865612647
124099,GBPUSD,18,-206.05,13,5,0.2777777777777778
124099,USDCHF,7,18.849999999999998,4,3,0.42857142857142855
124099,USDJPY,157,-2821.06,102,55,0.3503184713375796
124198,AUDJPY,8,2.3599999999999994,4,4,0.5
124198,AUDUSD,30,-219.76,20,10,0.3333333333333333
124198,CHFJPY,5,-9.539999999999996,3,2,0.4
124198,EURGBP,3,-50.21,3,0,0.0
124198,EURJPY,37,137.09,14,23,0.6216216216216216
124198,EURUSD,37,30.3,19,18,0.4864864864864865
124198,GBPJPY,2,-1.5699999999999994,1,1,0.5
124198,GBPUSD,28,-109.2,18,10,0.35714285714285715
124198,USDCAD,7,0.7799999999999976,4,3,0.42857142857142855
124198,USDCHF,19,-59.699999999999996,11,8,0.42105263157894735
124198,USDJPY,23,-50.120000000000005,12,11,0.4782608695652174
124357,AUDJPY,15,-194.49,11,4,0.26666666666666666
124357,AUDUSD,34,-18.1,18,16,0.47058823529411764
124357,CHFJPY,5,-48.69,4,1,0.2
124357,EURGBP,5,-63.5,3,2,0.4
124357,EURJPY,87,-38.739999999999945,56,31,0.3563218390804598
124357,EURUSD,49,-100.5,32,17,0.3469387755102041
124357,GBPJPY,45,-317.87,33,12,0.26666666666666666
124357,GBPUSD,38,-486.8,29,9,0.23684210526315788
124357,NZDUSD,7,-21.5,5,2,0.2857142857142857
124357,USDCAD,3,-66.69,3,0,0.0
124357,USDCHF,11,-17.720000000000002,7,4,0.36363636363636365
124357,USDJPY,20,-48.739999999999995,11,9,0.45
124510,AUDJPY,25,-438.29,13,12,0.48
124510,AUDUSD,30,-447.5,14,16,0.5333333333333333
124510,CHFJPY,5,-14.699999999999992,4,1,0.2
124510,EURGBP,3,-31.379999999999995,1,2,0.6666666666666666
124510,EURJPY,30,-181.76000000000008,8,22,0.7333333333333333
124510,EURUSD,49,-127.4,25,24,0.4897959183673469
124510,GBPJPY,7,-109.02,6,1,0.14285714285714285
124510,GBPUSD,29,-780.5,18,11,0.3793103448275862
124510,NZDUSD,1,-102.0,1,0,0.0
124510,USDCAD,7,-791.39,5,2,0.2857142857142857
124510,USDCHF,18,-202.63,12,6,0.3333333333333333
124510,USDJPY,13,52.190000000000005,7,6,0.46153846153846156
124581,AUDJPY,33,-204.61,23,10,0.30303030303030304
124581,AUDUSD,40,-164.9,22,18,0.45
124581,CHFJPY,1,2.08,0,1,1.0
124581,EURAUD,3,-21.22,3,0,0.0
124581,EURCAD,1,-4.7,1,0,0.0
124581,EURCHF,1,15.18,0,1,1.0
124581,EURGBP,2,-129.89,1,1,0.5
124581,EURJPY,85,-304.55,57,28,0.32941176470588235
124581,EURUSD,68,-215.5,34,34,0.5
124581,GBPJPY,70,-442.91,56,14,0.2
124581,GBPUSD,72,-181.79999999999998,44,28,0.3888888888888889
124581,NZDUSD,14,-38.3,9,5,0.35714285714285715
124581,USDCAD,7,37.22,3,4,0.5714285714285714
124581,USDCHF,7,69.21000000000001,4,3,0.42857142857142855
124581,USDJPY,35,90.77999999999999,21,14,0.4
124795,AUDJPY,36,-1227.84,19,17,0.4722222222222222
124795,AUDUSD,67,-992.8400000000001,33,34,0.5074626865671642
124795,CHFJPY,27,276.46000000000004,11,16,0.5925925925925926
124795,EURCHF,13,-896.9900000000001,6,7,0.5384615384615384
124795,EURGBP,7,-18.31,3,4,0.5714285714285714
124795,EURJPY,54,-950.2900000000001,24,30,0.5555555555555556
124795,EURUSD,66,58.19999999999999,29,37,0.5606060606060606
124795,GBPJPY,6,-60.12,5,1,0.16666666666666666
124795,GBPUSD,50,-234.0,27,23,0.46
124795,NZDUSD,2,-164.0,2,0,0.0
124795,USDCAD,7,60.440000000000005,3,4,0.5714285714285714
124795,USDCHF,40,717.6,18,22,0.55
124795,USDJPY,43,-102.96000000000001,23,20,0.46511627906976744
124805,AUDUSD,7,-15.449999999999996,5,2,0.2857142857142857
124805,EURCHF,16,-510.8,10,6,0.375
124805,EURUSD,211,-1363.9,81,130,0.6161137440758294
124805,GBPUSD,69,192.09,32,37,0.5362318840579711
124805,NZDUSD,14,-1.8,4,10,0.7142857142857143
124805,USDCAD,15,-81.04,7,8,0.5333333333333333
124805,USDCHF,26,207.42000000000002,7,19,0.7307692307692307
124805,USDJPY,31,163.14000000000001,11,20,0.6451612903225806
124805,XAGUSD,20,-220.9,8,12,0.6
124805,XAUUSD,65,1810.27,12,53,0.8153846153846154
124850,EURUSD,224,46.900000000000006,99,125,0.5580357142857143
124852,AUDUSD,1,1.8,0,1,1.0
124852,EURAUD,1,1.36,0,1,1.0
124852,EURUSD,10,-9.9,6,4,0.4
124852,GBPJPY,2,-13.34,2,0,0.0
124852,GBPUSD,100,-86.99999999999999,47,53,0.53
124852,USDCAD,1,-4.24,1,0,0.0
124852,USDCHF,2,2.47,0,2,1.0
124852,USDJPY,2,-5.67,2,0,0.0
124886,AUDUSD,20,-706.77,15,5,0.25
124886,EURUSD,14,1410.9800000000002,8,6,0.42857142857142855
124886,GBPJPY,21,-1481.44,15,6,0.2857142857142857
124886,GBPUSD,16,-854.1699999999998,10,6,0.375
124886,NZDUSD,15,-744.99,10,5,0.3333333333333333
124886,USDCAD,23,-4169.01,19,4,0.17391304347826086
124886,USDCHF,13,2319.6600000000003,5,8,0.6153846153846154
124886,USDJPY,20,-1651.6,15,5,0.25
125273,AUDUSD,21,-2382.75,15,6,0.2857142857142857
125273,EURUSD,15,3903.0200000000004,9,6,0.4
125273,GBPJPY,22,-6519.360000000001,16,6,0.2727272727272727
125273,GBPUSD,17,-4030.2099999999996,11,6,0.35294117647058826
125273,NZDUSD,16,4194.62,10,6,0.375
125273,USDCAD,23,-15506.99,20,3,0.13043478260869565
125273,USDCHF,15,4344.6900000000005,7,8,0.5333333333333333
125273,USDJPY,20,-6659.22,15,5,0.25
125363,AUDUSD,19,-4917.73,15,4,0.21052631578947367
125363,EURUSD,13,5734.139999999999,8,5,0.38461538461538464
125363,GBPJPY,21,-7837.990000000001,15,6,0.2857142857142857
125363,GBPUSD,15,1104.75,9,6,0.4
125363,NZDUSD,15,-3198.39,10,5,0.3333333333333333
125363,USDCAD,22,-16769.62,19,3,0.13636363636363635
125363,USDCHF,12,9639.51,5,7,0.5833333333333334
125363,USDJPY,18,-8202.7,14,4,0.2222222222222222
125452,AUDJPY,4,192.54,0,4,1.0
125452,AUDUSD,26,-233.75999999999996,11,15,0.5769230769230769
125452,CHFJPY,8,-1116.4199999999998,5,3,0.375
125452,EURAUD,6,-1720.48,2,4,0.6666666666666666
125452,EURCAD,1,-92.38,1,0,0.0
125452,EURGBP,8,72.14999999999998,3,5,0.625
125452,EURJPY,24,141.34999999999997,5,19,0.7916666666666666
125452,EURUSD,335,-5669.88,56,279,0.8328358208955224
125452,GBPCHF,2,-155.07999999999998,1,1,0.5
125452,GBPJPY,15,716.3299999999999,3,12,0.8
125452,GBPUSD,36,347.33000000000004,11,25,0.6944444444444444
125452,NZDUSD,19,587.6,3,16,0.8421052631578947
125452,USDCAD,7,-97.30000000000001,2,5,0.7142857142857143
125452,USDCHF,11,147.76,5,6,0.5454545454545454
125452,USDJPY,4,-164.32,1,3,0.75
125452,XAGUSD,1,-69.0,1,0,0.0
125452,XAUUSD,28,3687.75,8,20,0.7142857142857143
125564,AUDJPY,2,-1.5700000000000003,1,1,0.5
125564,AUDUSD,16,63.199999999999996,2,14,0.875
125564,EURCHF,4,-285.12,3,1,0.25
125564,EURJPY,12,64.92999999999999,1,11,0.9166666666666666
125564,EURUSD,167,-692.85,35,132,0.7904191616766467
125564,GBPJPY,5,41.14,1,4,0.8
125564,GBPUSD,18,-199.3,6,12,0.6666666666666666
125564,USDCAD,65,1.630000000000023,9,56,0.8615384615384616
125564,USDCHF,3,17.82,1,2,0.6666666666666666
125564,USDJPY,8,69.52000000000001,0,8,1.0
125586,EURCHF,1,285.43,0,1,1.0
125586,EURUSD,171,-1386.07,79,92,0.5380116959064327
125586,USDCHF,1,1.98,0,1,1.0
125586,XAUUSD,2,172.47,0,2,1.0
125868,AUDUSD,5,17.0,1,4,0.8
125868,CHFJPY,1,-21.45,1,0,0.0
125868,EURAUD,3,29.97,1,2,0.6666666666666666
125868,EURGBP,2,35.86,0,2,1.0
125868,EURJPY,4,6.7500000000000036,1,3,0.75
125868,EURUSD,148,-10329.0,56,92,0.6216216216216216
125868,GBPJPY,9,-413.97,7,2,0.2222222222222222
125868,GBPUSD,136,-6047.0,65,71,0.5220588235294118
125868,NZDUSD,3,-115.0,2,1,0.3333333333333333
125868,USDCAD,16,-246.1,6,10,0.625
125868,USDCHF,9,-888.24,5,4,0.4444444444444444
125868,USDJPY,19,-549.8199999999999,8,11,0.5789473684210527
125868,XAUUSD,35,586.3999999999999,5,30,0.8571428571428571
126050,AUDNZD,1,-592.16,1,0,0.0
126050,AUDUSD,44,-3209.55,13,31,0.7045454545454546
126050,EURCHF,1,-450.33,1,0,0.0
126050,EURUSD,225,-19876.64,27,198,0.88
126050,GBPUSD,47,12360.0,5,42,0.8936170212765957
126050,NZDUSD,1,-100.0,1,0,0.0
126050,USDCAD,6,2882.04,1,5,0.8333333333333334
126050,USDCHF,16,3552.13,3,13,0.8125
126050,USDJPY,41,-5417.77,5,36,0.8780487804878049
126108,EURJPY,90,-9507.71,49,41,0.45555555555555555
126108,EURUSD,384,1108.2099999999991,153,231,0.6015625
126108,GBPUSD,20,-370.0,9,11,0.55
126109,EURJPY,82,-1087.15,43,39,0.47560975609756095
126109,EURUSD,187,-2769.82,67,120,0.6417112299465241
126109,USDCHF,1,-13.16,1,0,0.0
126164,EURCHF,1,-50.47,1,0,0.0
126164,EURGBP,1,28.29,0,1,1.0
126164,EURJPY,8,485.75,3,5,0.625
126164,EURUSD,153,-3999.9,84,69,0.45098039215686275
126164,GBPJPY,4,332.85999999999996,1,3,0.75
126164,GBPUSD,18,-401.2,10,8,0.4444444444444444
126164,USDCHF,14,-994.24,11,3,0.21428571428571427
126164,USDJPY,3,116.37,1,2,0.6666666666666666
126171,AUDUSD,41,7391.0,4,37,0.9024390243902439
126171,CHFJPY,1,178.17,0,1,1.0
126171,EURJPY,75,12627.49,6,69,0.92
126171,EURUSD,51,9156.0,4,47,0.9215686274509803
126171,GBPJPY,7,2788.16,0,7,1.0
126171,GBPUSD,2,43.2,0,2,1.0
126199,AUDUSD,37,-16470.0,16,21,0.5675675675675675
126199,CADJPY,2,626.41,1,1,0.5
126199,EURJPY,60,-14645.890000000003,23,37,0.6166666666666667
126199,EURUSD,127,-10751.0,62,65,0.5118110236220472
126199,GBPJPY,103,-16880.93,62,41,0.39805825242718446
126199,GBPUSD,77,-3902.0,32,45,0.5844155844155844
126199,USDCAD,2,399.46000000000004,0,2,1.0
126199,USDCHF,75,-27755.8,45,30,0.4
126199,USDJPY,13,-2713.4399999999996,5,8,0.6153846153846154
126238,EURJPY,2,-147.0,2,0,0.0
126238,EURUSD,78,-1651.4,45,33,0.4230769230769231
126238,GBPJPY,2,11.940000000000001,1,1,0.5
126238,GBPUSD,19,-157.3,10,9,0.47368421052631576
126238,USDCAD,1,14.18,0,1,1.0
126238,USDCHF,1,21.97,0,1,1.0
126238,USDJPY,3,60.74,2,1,0.3333333333333333
126294,AUDUSD,1,2.0,0,1,1.0
126294,EURCHF,8,8.21,2,6,0.75
126294,EURGBP,6,-13.06,3,3,0.5
126294,EURJPY,1,-24.31,1,0,0.0
126294,EURUSD,645,-845.1500000000002,320,325,0.5038759689922481
126294,GBPCHF,6,30.57,1,5,0.8333333333333334
126294,GBPJPY,1,-85.1,1,0,0.0
126294,GBPUSD,148,-95.53,70,78,0.527027027027027
126294,USDCHF,113,-115.92999999999999,57,56,0.49557522123893805
126294,USDJPY,10,-63.959999999999994,8,2,0.2
126328,EURUSD,322,-2711.4,126,196,0.6086956521739131
126328,USDCAD,1,-3.36,1,0,0.0
126365,EURJPY,6,988.26,0,6,1.0
126365,EURUSD,145,-14757.6,59,86,0.593103448275862
126365,GBPJPY,4,240.58999999999997,1,3,0.75
126365,GBPUSD,140,7151.5,48,92,0.6571428571428571
126365,USDCAD,1,-209.38,1,0,0.0
126365,USDCHF,1,128.52,0,1,1.0
126365,USDJPY,2,36.54,1,1,0.5
126371,EURJPY,1,41.72,0,1,1.0
126371,EURUSD,110,-14603.4,38,72,0.6545454545454545
126371,GBPUSD,1,5.0,0,1,1.0
126371,USDJPY,1,244.43,0,1,1.0
126371,XAUUSD,34,-828.0400000000001,9,25,0.7352941176470589
126401,AUDUSD,6,-136.7,5,1,0.16666666666666666
126401,EURCAD,1,12.68,0,1,1.0
126401,EURCHF,10,-157.04,7,3,0.3
126401,EURGBP,1,-51.93,1,0,0.0
126401,EURJPY,177,-13175.489999999998,40,137,0.7740112994350282
126401,EURUSD,192,-3183.6,98,94,0.4895833333333333
126401,GBPCHF,9,183.85000000000002,5,4,0.4444444444444444
126401,GBPJPY,6,-336.11,3,3,0.5
126401,GBPUSD,109,-3827.8,53,56,0.5137614678899083
126401,NZDUSD,11,-1257.0,9,2,0.18181818181818182
126401,USDCAD,19,-10.26,13,6,0.3157894736842105
126401,USDCHF,34,-319.94,24,10,0.29411764705882354
126401,USDJPY,13,-367.03,10,3,0.23076923076923078
126429,AUDUSD,36,-179.0,9,27,0.75
126429,EURCHF,2,2.75,1,1,0.5
126429,EURJPY,5,-36.39,2,3,0.6
126429,EURUSD,195,-307.1,48,147,0.7538461538461538
126429,GBPUSD,61,-130.4,16,45,0.7377049180327869
126429,NZDUSD,4,41.0,0,4,1.0
126429,USDCHF,3,5.02,1,2,0.6666666666666666
126429,USDJPY,4,-5.29,2,2,0.5
126444,AUDUSD,14,-288.0,8,6,0.42857142857142855
126444,EURUSD,1452,-9161.75,148,1304,0.8980716253443526
126444,GBPJPY,10,-667.94,6,4,0.4
126460,AUDUSD,1,15.0,0,1,1.0
126460,EURCHF,1,36.62,0,1,1.0
126460,EURUSD,114,-4354.0,31,83,0.7280701754385965
126460,GBPUSD,35,-2067.3,12,23,0.6571428571428571
126460,USDJPY,4,50.39,1,3,0.75
126519,EURJPY,19,41.33,4,15,0.7894736842105263
126519,EURUSD,765,-2760.5,83,682,0.8915032679738563
126519,GBPJPY,4,26.369999999999997,0,4,1.0
126519,USDJPY,10,-34.25,2,8,0.8
126519,XAUUSD,6,-3.3,1,5,0.8333333333333334
126714,AUDCAD,1,42.88,0,1,1.0
126714,AUDJPY,8,-68.16999999999999,2,6,0.75
126714,AUDUSD,57,-6335.4,19,38,0.6666666666666666
126714,CADJPY,2,-1141.19,1,1,0.5
126714,CHFJPY,5,873.0699999999999,0,5,1.0
126714,EURAUD,5,739.96,0,5,1.0
126714,EURCAD,6,789.77,2,4,0.6666666666666666
126714,EURCHF,12,112.04000000000005,4,8,0.6666666666666666
126714,EURGBP,4,623.46,1,3,0.75
126714,EURJPY,10,39.84000000000001,2,8,0.8
126714,EURUSD,69,-26236.0,19,50,0.7246376811594203
126714,GBPCHF,6,953.31,2,4,0.6666666666666666
126714,GBPJPY,6,-254.45999999999992,2,4,0.6666666666666666
126714,GBPUSD,13,-5097.5,4,9,0.6923076923076923
126714,NZDUSD,3,450.0,0,3,1.0
126714,USDCAD,6,133.63999999999996,2,4,0.6666666666666666
126714,USDCHF,11,1557.53,2,9,0.8181818181818182
126714,USDJPY,16,-535.9,6,10,0.625
126784,EURUSD,50,-5088.95,15,35,0.7
126784,USDCHF,1,140.03,0,1,1.0
126784,XAGUSD,6,453.0,0,6,1.0
126784,XAUUSD,292,-12283.28,56,236,0.8082191780821918
126814,EURUSD,442,-19384.84,47,395,0.8936651583710408
126921,AUDCAD,12,-220.92,4,8,0.6666666666666666
126921,AUDNZD,7,-56.41999999999999,4,3,0.42857142857142855
126921,AUDUSD,10,-119.75999999999999,3,7,0.7
126921,CHFJPY,1,-103.66,1,0,0.0
126921,EURAUD,14,164.58,2,12,0.8571428571428571
126921,EURCAD,10,152.06,3,7,0.7
126921,EURCHF,8,-19.619999999999994,5,3,0.375
126921,EURGBP,6,3.320000000000004,2,4,0.6666666666666666
126921,EURUSD,2,-79.72,1,1,0.5
126921,GBPCHF,7,92.37,1,6,0.8571428571428571
126921,GBPUSD,3,80.42,0,3,1.0
126921,NZDUSD,9,-49.230000000000004,3,6,0.6666666666666666
126921,USDCAD,3,-123.51,2,1,0.3333333333333333
126921,USDCHF,5,78.69999999999999,1,4,0.8
126921,USDMXN,2,-12.88,1,1,0.5
126921,USDTRY,1,43.38,0,1,1.0
127008,AUDCAD,6,-7.41,4,2,0.3333333333333333
127008,AUDJPY,1,3.69,0,1,1.0
127008,AUDUSD,106,-67.52000000000001,50,56,0.5283018867924528
127008,CADJPY,2,-9.629999999999999,1,1,0.5
127008,CHFJPY,2,-9.979999999999999,1,1,0.5
127008,EURAUD,4,-32.03,3,1,0.25
127008,EURCAD,15,-32.480000000000004,8,7,0.4666666666666667
127008,EURCHF,19,-89.05,8,11,0.5789473684210527
127008,EURGBP,20,84.86,6,14,0.7
127008,EURJPY,22,-42.980000000000004,10,12,0.5454545454545454
127008,EURUSD,691,-3184.37,274,417,0.6034732272069464
127008,GBPCHF,2,-77.48,2,0,0.0
127008,GBPJPY,6,-42.93,1,5,0.8333333333333334
127008,GBPUSD,64,-77.96000000000002,31,33,0.515625
127008,NZDUSD,46,-715.27,25,21,0.45652173913043476
127008,USDCAD,18,-40.989999999999995,8,10,0.5555555555555556
127008,USDCHF,41,-53.84999999999999,10,31,0.7560975609756098
127008,USDJPY,36,-154.68,18,18,0.5
127008,USDMXN,1,1.86,0,1,1.0
127008,USDTRY,4,-47.53,2,2,0.5
127008,XAUUSD,10,208.74999999999997,4,6,0.6
127033,AUDCAD,3,-16.29,2,1,0.3333333333333333
127033,AUDUSD,3,0.07999999999999963,1,2,0.6666666666666666
127033,EURAUD,1,1.05,0,1,1.0
127033,EURCAD,4,-7.22,2,2,0.5
127033,EURCHF,1,0.8,0,1,1.0
127033,EURGBP,2,29.53,0,2,1.0
127033,EURJPY,5,-66.37,4,1,0.2
127033,EURUSD,17,-19.380000000000003,8,9,0.5294117647058824
127033,GBPCHF,4,-12.879999999999999,2,2,0.5
127033,GBPJPY,1,-4.25,1,0,0.0
127033,GBPUSD,4,-3.78,2,2,0.5
127033,NZDUSD,7,-17.77,6,1,0.14285714285714285
127033,USDCAD,8,21.31,5,3,0.375
127033,USDCHF,7,-19.47,2,5,0.7142857142857143
127033,USDJPY,1,-1.41,1,0,0.0
127033,XAGUSD,1,3.0,0,1,1.0
127033,XAUUSD,37,-319.15000000000003,17,20,0.5405405405405406
127149,AUDCAD,4,150.61,0,4,1.0
127149,AUDJPY,39,-770.53,18,21,0.5384615384615384
127149,AUDNZD,2,-52.5,1,1,0.5
127149,AUDUSD,43,-633.4000000000001,26,17,0.3953488372093023
127149,CADJPY,11,-2.3400000000000034,5,6,0.5454545454545454
127149,CHFJPY,7,-219.48,3,4,0.5714285714285714
127149,EURAUD,16,85.62,7,9,0.5625
127149,EURCAD,43,-2820.71,21,22,0.5116279069767442
127149,EURCHF,37,-401.07000000000005,17,20,0.5405405405405406
127149,EURGBP,22,-0.9799999999999933,9,13,0.5909090909090909
127149,EURJPY,46,435.73,15,31,0.6739130434782609
127149,EURUSD,61,-721.34,23,38,0.6229508196721312
127149,GBPCHF,19,-2447.4500000000003,9,10,0.5263157894736842
127149,GBPJPY,40,-1413.8,18,22,0.55
127149,GBPUSD,38,-181.18,12,26,0.6842105263157895
127149,NZDUSD,24,-392.53999999999996,6,18,0.75
127149,USDCAD,34,-423.70000000000005,18,16,0.47058823529411764
127149,USDCHF,37,-1347.4399999999998,18,19,0.5135135135135135
127149,USDJPY,53,320.6600000000001,25,28,0.5283018867924528
127149,USDMXN,6,-91.86000000000001,3,3,0.5
127149,USDTRY,9,-196.23000000000002,4,5,0.5555555555555556
127149,XAGUSD,17,-1074.3,8,9,0.5294117647058824
127149,XAUUSD,4,-879.9,3,1,0.25
127178,EURUSD,22,-186.0,12,10,0.45454545454545453
127178,USDTRY,1,-7.92,1,0,0.0
127178,XAGUSD,3,135.0,0,3,1.0
127178,XAUUSD,1786,-30949.39,174,1612,0.9025755879059351
127286,EURUSD,384,-1963.35,149,235,0.6119791666666666
127286,USDCHF,8,-295.22,6,2,0.25
127286,USDJPY,1,-135.47,1,0,0.0
127286,XAUUSD,23,10468.68,11,12,0.5217391304347826
155576,AUDJPY,18,257.46,8,10,0.5555555555555556
155576,AUDUSD,16,149.7,4,12,0.75
155576,CADJPY,24,307.97999999999996,12,12,0.5
155576,EURGBP,18,275.47,6,12,0.6666666666666666
155576,EURJPY,140,-10723.939999999999,53,87,0.6214285714285714
155576,EURUSD,100,-3776.7000000000003,27,73,0.73
155576,GBPCHF,24,278.19,3,21,0.875
155576,GBPJPY,17,381.2,2,15,0.8823529411764706
155576,GBPUSD,86,1747.2,16,70,0.813953488372093
155576,USDCHF,22,107.25,6,16,0.7272727272727273
155576,USDJPY,59,346.4400000000002,23,36,0.6101694915254238
155576,XAUUSD,13,271.54,3,10,0.7692307692307693
170002,AUDCAD,3,230.24,2,1,0.3333333333333333
170002,AUDJPY,2,-459.75000000000006,1,1,0.5
170002,AUDNZD,2,20.48,1,1,0.5
170002,AUDUSD,140,-6774.41,32,108,0.7714285714285715
170002,CADJPY,7,-18.09,1,6,0.8571428571428571
170002,CHFJPY,4,-178.06,2,2,0.5
170002,EURAUD,2,-0.46999999999999886,1,1,0.5
170002,EURCAD,7,815.6999999999998,1,6,0.8571428571428571
170002,EURCHF,19,3349.87,3,16,0.8421052631578947
170002,EURGBP,36,-1617.9099999999999,10,26,0.7222222222222222
170002,EURJPY,145,-429.99999999999994,36,109,0.7517241379310344
170002,EURUSD,1033,-7773.06,198,835,0.8083252662149081
170002,GBPCHF,5,-6157.26,3,2,0.4
170002,GBPJPY,24,-798.7,9,15,0.625
170002,GBPUSD,620,-937.4400000000004,140,480,0.7741935483870968
170002,NZDUSD,23,-447.9,5,18,0.782608695652174
170002,USDCAD,112,-35.920000000000286,21,91,0.8125
170002,USDCHF,59,-1958.47,16,43,0.7288135593220338
170002,USDJPY,93,-558.03,17,76,0.8172043010752689
170002,USDMXN,3,11.05,0,3,1.0
170002,XAGUSD,49,593.8,7,42,0.8571428571428571
170002,XAUUSD,257,-8468.48,36,221,0.8599221789883269
318462,AUDUSD,901,-12597.78,377,524,0.58157602663707
318462,EURJPY,3,-114.47999999999999,2,1,0.3333333333333333
318462,EURUSD,28,-372.0,14,14,0.5
318462,GBPUSD,41,-709.0,22,19,0.4634146341463415
318462,USDCHF,52,-198.0,44,8,0.15384615384615385
318462,USDJPY,7,-0.03999999999999204,3,4,0.5714285714285714
501160,AUDJPY,2,76.02000000000001,0,2,1.0
501160,AUDUSD,15,-240.0,8,7,0.4666666666666667
501160,EURAUD,2,-225.51999999999998,1,1,0.5
501160,EURCHF,20,-189.72,11,9,0.45
501160,EURGBP,28,-37.76999999999999,12,16,0.5714285714285714
501160,EURJPY,5,17.86,2,3,0.6
501160,EURUSD,42,382.7,8,34,0.8095238095238095
501160,GBPCHF,26,-89.85000000000001,13,13,0.5
501160,GBPJPY,73,-603.09,26,47,0.6438356164383562
501160,GBPUSD,59,196.2,22,37,0.6271186440677966
501160,NZDUSD,20,-180.1,15,5,0.25
501160,USDCAD,32,-244.45000000000002,19,13,0.40625
501160,USDCHF,25,-19.340000000000003,12,13,0.52
501160,USDJPY,25,-135.75000000000003,12,13,0.52
501747,EURUSD,105,-474.5,64,41,0.3904761904761905
501747,GBPUSD,5,-208.0,4,1,0.2
501747,USDJPY,5,-17.939999999999998,4,1,0.2
502111,EURUSD,6,-5.059999999999999,3,3,0.5
502111,GBPUSD,269,-822.0,180,89,0.3308550185873606
503401,AUDUSD,1,-9.0,1,0,0.0
503401,EURCHF,3,-34.989999999999995,2,1,0.3333333333333333
503401,EURGBP,3,65.36000000000001,1,2,0.6666666666666666
503401,EURUSD,120,-142.22,44,76,0.6333333333333333
503401,GBPUSD,26,-23.78,7,19,0.7307692307692307
503401,USDCAD,23,-83.02000000000001,9,14,0.6086956521739131
503401,USDCHF,31,-14.029999999999998,10,21,0.6774193548387096
503401,USDJPY,16,19.980000000000004,7,9,0.5625
503401,XAUUSD,64,-135.84,26,38,0.59375
503744,GBPJPY,227,3033.04,72,155,0.6828193832599119
503744,GBPUSD,15,269.9,6,9,0.6
503905,AUDCAD,53,-179.69,26,27,0.5094339622641509
503905,AUDJPY,40,153.0,13,27,0.675
503905,AUDUSD,62,-450.94000000000005,29,33,0.532258064516129
503905,CHFJPY,33,-95.26000000000002,13,20,0.6060606060606061
503905,EURAUD,15,-206.76,6,9,0.6
503905,EURCAD,44,-84.76,16,28,0.6363636363636364
503905,EURCHF,25,166.47999999999996,9,16,0.64
503905,EURGBP,40,163.22,9,31,0.775
503905,EURJPY,84,-307.77000000000004,23,61,0.7261904761904762
503905,EURUSD,75,-484.97,35,40,0.5333333333333333
503905,GBPCHF,92,102.26999999999998,31,61,0.6630434782608695
503905,GBPJPY,338,521.88,131,207,0.6124260355029586
503905,GBPUSD,284,-1118.93,131,153,0.5387323943661971
503905,NZDUSD,96,-281.2,36,60,0.625
503905,USDCAD,70,-11.3,28,42,0.6
503905,USDCHF,29,-95.05,11,18,0.6206896551724138
503905,USDJPY,31,27.27000000000001,8,23,0.7419354838709677
504319,AUDCAD,2,0.8500000000000001,0,2,1.0
504319,AUDJPY,5,3.65,1,4,0.8
504319,AUDNZD,8,-32.67,3,5,0.625
504319,AUDUSD,267,-1700.7,73,194,0.7265917602996255
504319,CADJPY,9,3.0100000000000007,3,6,0.6666666666666666
504319,CHFJPY,10,-15.02,5,5,0.5
504319,EURAUD,14,2.2200000000000006,5,9,0.6428571428571429
504319,EURCAD,9,30.81,0,9,1.0
504319,EURCHF,20,0.03000000000000047,4,16,0.8
504319,EURGBP,67,25.82000000000002,19,48,0.7164179104477612
504319,EURJPY,15,-62.900000000000006,5,10,0.6666666666666666
504319,EURUSD,707,-911.46,200,507,0.7171145685997171
504319,GBPCHF,11,-37.33,8,3,0.2727272727272727
504319,GBPJPY,5,-14.790000000000001,3,2,0.4
504319,GBPUSD,57,-139.7,25,32,0.5614035087719298
504319,NZDUSD,8,-159.11,4,4,0.5
504319,USDCAD,8,-11.040000000000001,2,6,0.75
504319,USDCHF,6,18.24,1,5,0.8333333333333334
504319,USDJPY,13,-57.660000000000004,6,7,0.5384615384615384
504319,USDMXN,3,3.38,0,3,1.0
504319,USDTRY,2,-9.379999999999999,1,1,0.5
504319,XAGUSD,15,-32.2,7,8,0.5333333333333333
504319,XAUUSD,8,-6.52,1,7,0.875
504488,AUDUSD,1,-156.0,1,0,0.0
504488,EURJPY,7,-367.16,5,2,0.2857142857142857
504488,EURUSD,9,-502.0,5,4,0.4444444444444444
504488,GBPUSD,137,-731.0,67,70,0.5109489051094891
504488,NZDUSD,3,-184.0,3,0,0.0
504488,USDCAD,2,-259.48,2,0,0.0
504488,USDCHF,1,-99.84,1,0,0.0
504488,USDJPY,3,-271.52,3,0,0.0
504694,AUDJPY,1,110.91,0,1,1.0
504694,AUDUSD,267,338.39999999999964,25,242,0.9063670411985019
504694,EURAUD,38,3838.07,1,37,0.9736842105263158
504694,EURCAD,6,-18.419999999999998,2,4,0.6666666666666666
504694,EURCHF,83,-11989.8,15,68,0.8192771084337349
504694,EURGBP,9,-1200.0700000000002,3,6,0.6666666666666666
504694,EURJPY,37,-1076.3900000000003,8,29,0.7837837837837838
504694,EURUSD,410,4419.9,45,365,0.8902439024390244
504694,GBPCHF,3,20.33,0,3,1.0
504694,GBPJPY,30,-9621.52,7,23,0.7666666666666667
504694,GBPUSD,184,4254.9,16,168,0.9130434782608695
504694,NZDUSD,88,5628.3,4,84,0.9545454545454546
504694,USDCAD,54,3187.13,6,48,0.8888888888888888
504694,USDCHF,18,-1559.17,3,15,0.8333333333333334
504694,USDJPY,73,2162.1900000000005,13,60,0.821917808219178
504694,XAGUSD,5,-96.39999999999999,4,1,0.2
504694,XAUUSD,210,8233.12,29,181,0.861904761904762
504839,AUDUSD,11,-1855.5,7,4,0.36363636363636365
504839,EURGBP,2,15.399999999999999,1,1,0.5
504839,EURJPY,16,386.87,8,8,0.5
504839,EURUSD,59,-8931.3,36,23,0.3898305084745763
504839,GBPJPY,19,-698.16,10,9,0.47368421052631576
504839,GBPUSD,33,-3983.0,18,15,0.45454545454545453
504839,NZDUSD,2,-1.7999999999999998,1,1,0.5
504839,USDCAD,3,17.6,0,3,1.0
504839,USDCHF,18,-2223.32,10,8,0.4444444444444444
504839,USDJPY,9,-804.48,4,5,0.5555555555555556
504839,XAUUSD,2,175.5,1,1,0.5
504908,AUDJPY,2,-94.7,2,0,0.0
504908,AUDUSD,1,94.0,0,1,1.0
504908,EURUSD,1,-4.0,1,0,0.0
504908,GBPJPY,395,-7623.68,227,168,0.4253164556962025
504908,GBPUSD,26,-80.0,14,12,0.46153846153846156
504908,USDCAD,2,-14.43,2,0,0.0
504908,USDMXN,2,-28.130000000000003,2,0,0.0
505409,AUDUSD,12,-437.0,4,8,0.6666666666666666
505409,EURUSD,357,-1663.95,113,244,0.6834733893557423
505409,GBPUSD,6,-119.0,2,4,0.6666666666666666
505409,USDCAD,52,-732.39,24,28,0.5384615384615384
505409,USDCHF,39,-15.069999999999995,15,24,0.6153846153846154
505409,XAGUSD,3,-320.0,2,1,0.3333333333333333
505409,XAUUSD,109,-65.13999999999999,21,88,0.8073394495412844
505666,EURCHF,1,-27.14,1,0,0.0
505666,EURUSD,96,-57.4,9,87,0.90625
505666,GBPUSD,470,-103.12999999999997,119,351,0.7468085106382979
505666,USDCHF,17,-161.68,5,12,0.7058823529411765
505666,USDJPY,3,-49.76,3,0,0.0
505676,AUDCAD,7,-19.43,5,2,0.2857142857142857
505676,AUDUSD,2,-3.89,1,1,0.5
505676,CADJPY,1,0.07,0,1,1.0
505676,EURCHF,15,23.71,4,11,0.7333333333333333
505676,EURJPY,7,-18.490000000000002,4,3,0.42857142857142855
505676,EURUSD,142,-223.36,72,70,0.49295774647887325
505676,GBPUSD,39,-39.98,25,14,0.358974358974359
505676,USDCHF,11,-9.56,5,6,0.5454545454545454
505676,USDJPY,39,111.1,12,27,0.6923076923076923
505676,USDTRY,3,-7.48,3,0,0.0
505676,XAUUSD,3,3.9699999999999998,1,2,0.6666666666666666
505884,AUDUSD,1,10.0,0,1,1.0
505884,EURUSD,142,-357.74,48,94,0.6619718309859155
505884,GBPJPY,2,3.9899999999999984,1,1,0.5
505884,GBPUSD,5,-25.0,2,3,0.6
505884,USDCAD,2,-14.060000000000002,1,1,0.5
505884,USDCHF,1,-1.61,1,0,0.0
505936,AUDNZD,1,0.04,0,1,1.0
505936,AUDUSD,11,106.35,0,11,1.0
505936,EURCHF,2,-24.46,1,1,0.5
505936,EURUSD,157,-280.3,47,110,0.7006369426751592
505936,NZDUSD,30,-798.74,11,19,0.6333333333333333
505936,USDCHF,5,7.18,1,4,0.8
505936,USDJPY,4,-25.57,3,1,0.25
505953,EURUSD,661,-3494.5,148,513,0.7760968229954615
505953,GBPJPY,21,-1501.8899999999999,5,16,0.7619047619047619
505953,GBPUSD,392,-555.0,85,307,0.7831632653061225
505953,USDJPY,1,57.77,0,1,1.0
505953,XAUUSD,11,-116.79999999999998,5,6,0.5454545454545454
505985,AUDUSD,40,-42.349999999999994,20,20,0.5
505985,EURCHF,1,-71.46,1,0,0.0
505985,EURGBP,5,-92.34,5,0,0.0
505985,EURJPY,15,-74.65000000000005,6,9,0.6
505985,EURUSD,90,266.20000000000005,42,48,0.5333333333333333
505985,GBPCHF,12,-717.5300000000001,4,8,0.6666666666666666
505985,GBPJPY,113,178.56000000000006,18,95,0.8407079646017699
505985,GBPUSD,68,-204.2,30,38,0.5588235294117647
505985,NZDUSD,1,-18.0,1,0,0.0
505985,USDCHF,4,9.099999999999998,1,3,0.75
505985,USDJPY,2,-30.17,1,1,0.5
506028,AUDJPY,4,-46.1,4,0,0.0
506028,AUDUSD,20,-52.2,15,5,0.25
506028,EURCHF,9,-27.56,7,2,0.2222222222222222
506028,EURGBP,16,17.7,8,8,0.5
506028,EURJPY,22,-100.05999999999999,10,12,0.5454545454545454
506028,EURUSD,89,86.74,42,47,0.5280898876404494
506028,GBPCHF,2,3.63,0,2,1.0
506028,GBPJPY,20,-157.07999999999998,11,9,0.45
506028,GBPUSD,23,-49.8,13,10,0.43478260869565216
506028,NZDUSD,1,-5.6,1,0,0.0
506028,USDCAD,18,24.62,7,11,0.6111111111111112
506028,USDCHF,31,-35.86,16,15,0.4838709677419355
506028,USDJPY,39,-77.46000000000001,19,20,0.5128205128205128
506457,AUDUSD,24,-333.65,17,7,0.2916666666666667
506457,EURUSD,19,437.72999999999996,11,8,0.42105263157894735
506457,GBPJPY,24,-554.66,17,7,0.2916666666666667
506457,GBPUSD,18,-70.45000000000002,11,7,0.3888888888888889
506457,NZDUSD,20,-27.400000000000034,13,7,0.35
506457,USDCAD,27,-1141.12,21,6,0.2222222222222222
506457,USDCHF,19,-38.750000000000014,10,9,0.47368421052631576
506457,USDJPY,26,-1065.54,21,5,0.19230769230769232
506795,AUDUSD,4,-8.8,2,2,0.5
506795,EURUSD,147,-9998.0,54,93,0.6326530612244898
506795,GBPJPY,140,-2196.8499999999995,44,96,0.6857142857142857
506795,GBPUSD,131,-1904.0,43,88,0.6717557251908397
506795,USDCAD,1,-11.43,1,0,0.0
506795,USDJPY,2,-113.6,2,0,0.0
506975,AUDNZD,202,-303.23,100,102,0.504950495049505
506975,CHFJPY,104,-101.22999999999998,41,63,0.6057692307692307
506975,EURUSD,17,45.45,3,14,0.8235294117647058
506975,USDCAD,5,-3.659999999999999,2,3,0.6
506975,USDCHF,5,-30.189999999999998,3,2,0.4
507142,AUDUSD,2,-1.7999999999999998,1,1,0.5
507142,EURCHF,42,-582.77,6,36,0.8571428571428571
507142,EURGBP,4,-518.2,3,1,0.25
507142,EURJPY,1,1.99,0,1,1.0
507142,EURUSD,230,-1387.25,80,150,0.6521739130434783
507142,GBPJPY,1,16.94,0,1,1.0
507142,GBPUSD,45,795.6,13,32,0.7111111111111111
507142,USDCAD,1,11.28,0,1,1.0
507142,USDCHF,148,-860.09,50,98,0.6621621621621622
507142,USDJPY,63,-689.1700000000001,15,48,0.7619047619047619
507142,XAGUSD,2,-22.1,1,1,0.5
507142,XAUUSD,37,12.639999999999995,5,32,0.8648648648648649
507431,EURJPY,10,-38.32,7,3,0.3
507431,EURUSD,443,-660.38,182,261,0.5891647855530474
507431,GBPUSD,8,3.88,2,6,0.75
507431,USDCHF,1,13.75,0,1,1.0
507431,USDJPY,8,-41.5,6,2,0.25
507439,EURCHF,1,28.37,0,1,1.0
507439,EURUSD,79,-471.0,41,38,0.4810126582278481
507439,GBPUSD,44,-2.0,19,25,0.5681818181818182
507439,USDCAD,1,-41.44,1,0,0.0
507439,USDCHF,4,16.529999999999998,1,3,0.75
507439,USDJPY,1,2.04,0,1,1.0
507854,AUDCAD,2,-1.49,2,0,0.0
507854,AUDJPY,10,-117.97999999999999,7,3,0.3
507854,EURCHF,3,2.54,0,3,1.0
507854,EURJPY,29,3.900000000000002,7,22,0.7586206896551724
507854,EURUSD,616,-694.65,258,358,0.5811688311688312
507854,GBPJPY,10,1.2499999999999987,6,4,0.4
507854,GBPUSD,144,-264.17,84,60,0.4166666666666667
507854,NZDUSD,6,-37.8,5,1,0.16666666666666666
507854,USDCHF,3,0.05999999999999961,2,1,0.3333333333333333
507854,USDJPY,21,-41.800000000000004,11,10,0.47619047619047616
507854,USDMXN,1,-5.78,1,0,0.0
508071,AUDJPY,11,-554.08,10,1,0.09090909090909091
508071,AUDUSD,18,-619.3,16,2,0.1111111111111111
508071,EURUSD,59,-2140.9,34,25,0.423728813559322
508071,USDCAD,6,-5.550000000000001,2,4,0.6666666666666666
508071,USDCHF,8,-88.94999999999999,7,1,0.125
508071,USDJPY,6,-68.38,6,0,0.0
508071,XAGUSD,38,-92.30000000000001,25,13,0.34210526315789475
508289,AUDJPY,8,-23.949999999999996,1,7,0.875
508289,AUDUSD,104,-99.60000000000001,20,84,0.8076923076923077
508289,EURGBP,2,2.8200000000000003,0,2,1.0
508289,EURJPY,18,105.46000000000001,3,15,0.8333333333333334
508289,EURUSD,7,-173.7,3,4,0.5714285714285714
508289,GBPJPY,11,-892.4799999999999,1,10,0.9090909090909091
508289,GBPUSD,14,-688.8,2,12,0.8571428571428571
508289,NZDUSD,12,2.799999999999997,1,11,0.9166666666666666
508289,USDCAD,2,2.77,0,2,1.0
508289,USDCHF,3,1.69,0,3,1.0
508289,USDJPY,2,3.8600000000000003,0,2,1.0
508803,AUDCAD,1,-1.03,1,0,0.0
508803,AUDJPY,1,5.23,0,1,1.0
508803,AUDUSD,7,-2.1,3,4,0.5714285714285714
508803,EURCAD,1,4.07,0,1,1.0
508803,EURCHF,9,1.8500000000000003,4,5,0.5555555555555556
508803,EURGBP,8,-7.74,5,3,0.375
508803,EURJPY,47,-224.57,25,22,0.46808510638297873
508803,EURUSD,345,-280.4,167,178,0.5159420289855072
508803,GBPCHF,11,-142.84,8,3,0.2727272727272727
508803,GBPJPY,65,102.66999999999999,26,39,0.6
508803,GBPUSD,101,-72.1,48,53,0.5247524752475248
508803,NZDUSD,3,-0.30000000000000004,1,2,0.6666666666666666
508803,USDCAD,7,2.3099999999999996,4,3,0.42857142857142855
508803,USDCHF,18,-24.79,12,6,0.3333333333333333
508803,USDJPY,29,-110.27000000000001,16,13,0.4482758620689655
509069,AUDJPY,2,-318.99,2,0,0.0
509069,AUDUSD,6,-976.0,5,1,0.16666666666666666
509069,EURJPY,2,-374.27,2,0,0.0
509069,EURUSD,1275,-693.23,228,1047,0.8211764705882353
509069,USDCAD,1,199.4,0,1,1.0
509069,USDJPY,1,-311.21,1,0,0.0
509239,AUDNZD,1,-2.01,1,0,0.0
509239,AUDUSD,7,23.9,2,5,0.7142857142857143
509239,EURGBP,16,-255.98999999999995,4,12,0.75
509239,EURUSD,67,-320.4,18,49,0.7313432835820896
509239,GBPCHF,4,-147.78,2,2,0.5
509239,GBPJPY,1,-11.08,1,0,0.0
509239,GBPUSD,71,27.800000000000004,17,54,0.7605633802816901
509239,USDCAD,28,180.4,5,23,0.8214285714285714
509239,USDCHF,28,-32.55,7,21,0.75
509239,USDJPY,16,81.12,2,14,0.875
509319,AUDUSD,13,-137.0,10,3,0.23076923076923078
509319,EURJPY,33,-368.13000000000005,24,9,0.2727272727272727
509319,EURUSD,147,-1113.25,76,71,0.48299319727891155
509319,GBPUSD,50,-87.0,31,19,0.38
509319,USDCAD,1,0.0,1,0,0.0
509319,USDCHF,8,46.35,3,5,0.625
509319,USDJPY,10,-15.850000000000003,5,5,0.5
509424,EURUSD,186,797.34,24,162,0.8709677419354839
509424,GBPJPY,53,-417.85,18,35,0.660377358490566
509424,GBPUSD,187,412.7,26,161,0.8609625668449198
509537,CHFJPY,9,926.05,2,7,0.7777777777777778
509537,EURCHF,2,68.45,0,2,1.0
509537,EURGBP,1,0.0,1,0,0.0
509537,EURUSD,10,-695.5,8,2,0.2
509537,GBPUSD,1,130.0,0,1,1.0
509537,USDCAD,55,-2340.13,13,42,0.7636363636363637
509537,USDJPY,30,-143.2999999999999,3,27,0.9
510012,AUDUSD,2,3.45,0,2,1.0
510012,EURUSD,469,-852.09,217,252,0.5373134328358209
510012,GBPUSD,5,-6.0,4,1,0.2
510012,USDJPY,6,35.34,2,4,0.6666666666666666
510012,XAGUSD,1,93.2,0,1,1.0
510012,XAUUSD,18,-1176.13,11,7,0.3888888888888889
510245,AUDJPY,65,-98.14,29,36,0.5538461538461539
510245,AUDUSD,105,2.4999999999999942,35,70,0.6666666666666666
510245,EURGBP,1,5.08,0,1,1.0
510245,EURJPY,100,-144.72,46,54,0.54
510245,EURUSD,59,-52.599999999999994,23,36,0.6101694915254238
510245,GBPJPY,15,17.18,5,10,0.6666666666666666
510245,GBPUSD,84,-453.7,40,44,0.5238095238095238
510245,NZDUSD,17,-5.799999999999999,6,11,0.6470588235294118
510245,USDCHF,1,1.72,0,1,1.0
510245,USDJPY,14,-57.56,6,8,0.5714285714285714
510850,AUDCAD,1,-33.05,1,0,0.0
510850,AUDUSD,18,6.689999999999999,7,11,0.6111111111111112
510850,CHFJPY,15,-33.519999999999996,7,8,0.5333333333333333
510850,EURCAD,33,-31.389999999999997,18,15,0.45454545454545453
510850,EURCHF,26,-120.69999999999999,10,16,0.6153846153846154
510850,EURGBP,99,-687.37,51,48,0.48484848484848486
510850,EURJPY,43,-130.72,22,21,0.4883720930232558
510850,EURUSD,407,-308.92,185,222,0.5454545454545454
510850,GBPCHF,50,25.979999999999986,24,26,0.52
510850,GBPJPY,50,-376.68,25,25,0.5
510850,GBPUSD,251,-886.61,108,143,0.5697211155378487
510850,NZDUSD,20,27.640000000000004,7,13,0.65
510850,USDCAD,48,-50.82,19,29,0.6041666666666666
510850,USDCHF,125,-101.47,53,72,0.576
510850,USDJPY,61,58.38,21,40,0.6557377049180327
510850,USDMXN,7,-13.499999999999998,5,2,0.2857142857142857
510958,AUDUSD,33,1877.0,6,27,0.8181818181818182
510958,EURCHF,1,-9.63,1,0,0.0
510958,EURUSD,42,-1429.0,14,28,0.6666666666666666
510958,GBPJPY,10,-4243.82,5,5,0.5
510958,GBPUSD,67,-4460.0,24,43,0.6417910447761194
510958,USDCHF,66,-2390.38,32,34,0.5151515151515151
510958,USDJPY,87,-9728.72,29,58,0.6666666666666666
510958,XAUUSD,26,239.0000000000001,7,19,0.7307692307692307
511326,EURUSD,109,-2616.54,69,40,0.3669724770642202
511326,GBPJPY,1,-61.9,1,0,0.0
511560,AUDCAD,1,-3.82,1,0,0.0
511560,AUDJPY,1,-3.23,1,0,0.0
511560,AUDUSD,4,-8.5,3,1,0.25
511560,CHFJPY,2,-5.720000000000001,2,0,0.0
511560,EURCHF,3,-5.35,3,0,0.0
511560,EURGBP,1,3.05,0,1,1.0
511560,EURUSD,29,-235.6,19,10,0.3448275862068966
511560,GBPJPY,2,-615.79,2,0,0.0
511560,GBPUSD,169,387.34000000000003,89,80,0.47337278106508873
511560,NZDUSD,3,2.6,1,2,0.6666666666666666
511560,USDCHF,1,-5.08,1,0,0.0
511560,USDJPY,4,4.239999999999999,1,3,0.75
517057,AUDCAD,2,-30.91,1,1,0.5
517057,AUDJPY,10,93.55,1,9,0.9
517057,AUDUSD,7,-77.5,2,5,0.7142857142857143
517057,CADJPY,2,-9.380000000000003,1,1,0.5
517057,CHFJPY,8,16.72,2,6,0.75
517057,EURAUD,12,129.39000000000001,0,12,1.0
517057,EURCHF,5,25.419999999999998,1,4,0.8
517057,EURJPY,7,91.63,0,7,1.0
517057,EURUSD,13,12.8,3,10,0.7692307692307693
517057,GBPCHF,2,15.51,0,2,1.0
517057,GBPJPY,19,-203.78,4,15,0.7894736842105263
517057,GBPUSD,18,-163.5,6,12,0.6666666666666666
517057,USDCAD,7,71.74,0,7,1.0
517057,USDCHF,6,-156.96,1,5,0.8333333333333334
517057,USDJPY,9,-31.810000000000002,3,6,0.6666666666666666
517179,AUDCAD,18,-244.28,14,4,0.2222222222222222
517179,AUDJPY,4,-25.36,3,1,0.25
517179,AUDNZD,8,-31.35,2,6,0.75
517179,AUDUSD,46,-89.46000000000001,26,20,0.43478260869565216
517179,CADJPY,4,-83.51,2,2,0.5
517179,CHFJPY,2,16.740000000000002,0,2,1.0
517179,EURAUD,13,81.95,2,11,0.8461538461538461
517179,EURCAD,8,-42.42,6,2,0.25
517179,EURCHF,19,37.099999999999994,3,16,0.8421052631578947
517179,EURGBP,47,-221.89000000000001,25,22,0.46808510638297873
517179,EURJPY,26,21.200000000000003,11,15,0.5769230769230769
517179,EURUSD,334,-778.2099999999999,176,158,0.47305389221556887
517179,GBPCHF,9,-38.940000000000005,6,3,0.3333333333333333
517179,GBPJPY,31,-95.91,14,17,0.5483870967741935
517179,GBPUSD,44,61.370000000000005,15,29,0.6590909090909091
517179,NZDUSD,97,-406.25,56,41,0.422680412371134
517179,USDCAD,10,-43.52,8,2,0.2
517179,USDCHF,23,-97.18,13,10,0.43478260869565216
517179,USDJPY,37,-84.75999999999999,18,19,0.5135135135135135
517179,USDMXN,7,-4.42,4,3,0.42857142857142855
517179,XAGUSD,1,4.2,0,1,1.0
517179,XAUUSD,1,45.12,0,1,1.0
517279,AUDJPY,1,12.43,0,1,1.0
517279,AUDUSD,11,-26.040000000000003,6,5,0.45454545454545453
517279,CADJPY,3,10.15,0,3,1.0
517279,EURJPY,1,18.4,0,1,1.0
517279,EURUSD,740,-241.32,319,421,0.5689189189189189
517279,GBPCHF,2,22.36,0,2,1.0
517279,GBPUSD,8,19.82,3,5,0.625
517279,NZDUSD,8,77.24,2,6,0.75
517279,USDCAD,2,14.52,0,2,1.0
517279,USDCHF,89,-118.33000000000003,28,61,0.6853932584269663
517279,USDJPY,93,1536.62,15,78,0.8387096774193549
517279,XAUUSD,9,-122.28999999999999,7,2,0.2222222222222222
517592,AUDJPY,1,1.05,0,1,1.0
517592,AUDUSD,14,-56.1,8,6,0.42857142857142855
517592,EURGBP,8,34.06999999999999,6,2,0.25
517592,EURJPY,14,2.3999999999999995,9,5,0.35714285714285715
517592,EURUSD,53,-90.1,32,21,0.39622641509433965
517592,GBPJPY,39,-83.49000000000001,16,23,0.5897435897435898
517592,GBPUSD,56,17.899999999999995,27,29,0.5178571428571429
517592,NZDUSD,1,-10.8,1,0,0.0
517592,USDCAD,6,-9.34,4,2,0.3333333333333333
517592,USDCHF,14,50.44,3,11,0.7857142857142857
517592,USDJPY,13,-46.34,9,4,0.3076923076923077
517592,XAUUSD,3,-2.73,2,1,0.3333333333333333
517833,EURJPY,173,-170.99000000000004,87,86,0.49710982658959535
517833,GBPUSD,191,-493.9,80,111,0.581151832460733
517919,AUDJPY,1,-1.64,1,0,0.0
517919,AUDUSD,2,7.800000000000001,1,1,0.5
517919,EURGBP,1,-32.98,1,0,0.0
517919,EURJPY,95,-262.33,51,44,0.4631578947368421
517919,EURUSD,50,-124.05000000000001,27,23,0.46
517919,GBPUSD,315,-905.89,161,154,0.4888888888888889
517919,USDCAD,6,2.33,2,4,0.6666666666666666
517919,USDCHF,8,-2.09,5,3,0.375
517919,USDJPY,7,-17.23,6,1,0.14285714285714285
518004,AUDUSD,21,-59.699999999999996,5,16,0.7619047619047619
518004,EURCAD,1,2.15,0,1,1.0
518004,EURCHF,2,-10.87,1,1,0.5
518004,EURGBP,4,-9.52,3,1,0.25
518004,EURJPY,3,-10.790000000000001,2,1,0.3333333333333333
518004,EURUSD,62,-618.6,21,41,0.6612903225806451
518004,GBPCHF,1,6.29,0,1,1.0
518004,GBPJPY,3,-49.239999999999995,2,1,0.3333333333333333
518004,GBPUSD,540,-483.70000000000005,79,461,0.8537037037037037
518004,NZDUSD,1,-5.0,1,0,0.0
518004,USDCAD,2,-3.31,1,1,0.5
518004,USDCHF,14,-0.4800000000000004,7,7,0.5
518004,USDJPY,5,5.62,2,3,0.6
518024,EURUSD,1537,-4893.06,650,887,0.5770982433311646
518024,GBPJPY,2,-123.13000000000001,1,1,0.5
518024,NZDUSD,6,-46.0,4,2,0.3333333333333333
518024,USDCHF,1,0.93,0,1,1.0
518024,USDJPY,20,33.449999999999996,4,16,0.8
518093,AUDJPY,4,-18.37,2,2,0.5
518093,AUDUSD,295,-830.26,175,120,0.4067796610169492
518093,EURJPY,35,-144.07,18,17,0.4857142857142857
518093,EURUSD,342,-666.17,183,159,0.4649122807017544
518093,GBPJPY,8,-45.62,4,4,0.5
518093,GBPUSD,168,-562.52,91,77,0.4583333333333333
518093,NZDUSD,94,-110.9,47,47,0.5
518093,USDCAD,1,-10.03,1,0,0.0
518093,USDCHF,2,43.9,0,2,1.0
518093,USDJPY,142,-266.41,79,63,0.44366197183098594
518189,AUDJPY,8,-113.84,7,1,0.125
518189,AUDUSD,46,-172.9,23,23,0.5
518189,EURUSD,97,-64.3,51,46,0.4742268041237113
518189,GBPUSD,1,-3.5,1,0,0.0
518189,USDCHF,7,-10.760000000000002,5,2,0.2857142857142857
518298,AUDCAD,12,-41.56,8,4,0.3333333333333333
518298,AUDJPY,58,-69.73,23,35,0.603448275862069
518298,AUDNZD,24,-91.84,15,9,0.375
518298,AUDUSD,171,-285.93,58,113,0.6608187134502924
518298,CADJPY,32,-159.09,17,15,0.46875
518298,CHFJPY,50,1.100000000000001,15,35,0.7
518298,EURAUD,57,-105.17999999999999,25,32,0.5614035087719298
518298,EURCAD,33,-48.64000000000001,13,20,0.6060606060606061
518298,EURCHF,17,34.72,5,12,0.7058823529411765
518298,EURGBP,98,-288.04,50,48,0.4897959183673469
518298,EURJPY,69,-111.32,19,50,0.7246376811594203
518298,EURUSD,402,-2301.07,160,242,0.6019900497512438
518298,GBPCHF,19,2.0999999999999983,6,13,0.6842105263157895
518298,GBPJPY,186,-245.01,73,113,0.6075268817204301
518298,GBPUSD,581,-466.84999999999997,230,351,0.6041308089500861
518298,NZDUSD,60,-79.15,26,34,0.5666666666666667
518298,USDCAD,267,-304.48,113,154,0.5767790262172284
518298,USDCHF,179,-157.18,75,104,0.5810055865921788
518298,USDJPY,214,-285.4,92,122,0.5700934579439252
518753,AUDJPY,57,-555.51,36,21,0.3684210526315789
518753,AUDUSD,12,29.0,4,8,0.6666666666666666
518753,CADJPY,117,-744.5,72,45,0.38461538461538464
518753,CHFJPY,1,-10.26,1,0,0.0
518753,EURJPY,452,-3080.98,281,171,0.37831858407079644
518753,EURUSD,341,-690.9499999999999,205,136,0.39882697947214074
518753,GBPCHF,127,-555.53,81,46,0.36220472440944884
518753,GBPJPY,319,-1658.77,202,117,0.3667711598746082
518753,GBPUSD,544,-576.75,300,244,0.4485294117647059
518753,USDCHF,12,-264.33,8,4,0.3333333333333333
518782,AUDUSD,36,378.0,12,24,0.6666666666666666
518782,EURCHF,2,18.270000000000003,1,1,0.5
518782,EURGBP,4,-671.0699999999999,3,1,0.25
518782,EURJPY,50,2925.71,17,33,0.66
518782,EURUSD,47,6938.0,14,33,0.7021276595744681
518782,GBPUSD,78,5504.0,36,42,0.5384615384615384
518782,NZDUSD,7,1581.0,2,5,0.7142857142857143
518782,USDCAD,29,-2173.2799999999997,17,12,0.41379310344827586
518782,USDCHF,10,-742.11,5,5,0.5
518782,USDJPY,21,521.9,8,13,0.6190476190476191
518836,AUDCAD,1,41.38,0,1,1.0
518836,AUDJPY,14,66.62,4,10,0.7142857142857143
518836,AUDUSD,164,-221.0,82,82,0.5
518836,CHFJPY,6,146.75,1,5,0.8333333333333334
518836,EURGBP,6,47.449999999999996,2,4,0.6666666666666666
518836,EURJPY,1616,-6923.78,782,834,0.5160891089108911
518836,EURUSD,544,-755.6999999999999,265,279,0.5128676470588235
518836,GBPCHF,30,-524.1,15,15,0.5
518836,GBPJPY,124,-1215.06,58,66,0.532258064516129
518836,GBPUSD,1246,-4269.0,650,596,0.478330658105939
518836,NZDUSD,2,-24.8,2,0,0.0
518836,USDCAD,103,-641.57,64,39,0.3786407766990291
518836,USDCHF,26,-159.70999999999998,12,14,0.5384615384615384
518836,USDJPY,21,-83.73000000000002,10,11,0.5238095238095238
519079,EURUSD,1398,-18473.27,773,625,0.4470672389127325
519079,GBPUSD,7,-483.08,7,0,0.0
519079,USDCAD,6,18.050000000000004,3,3,0.5
519098,AUDUSD,1,10.0,0,1,1.0
519098,EURJPY,1,22.34,0,1,1.0
519098,GBPUSD,265,-7706.0,66,199,0.7509433962264151
519098,USDCAD,1,-6.23,1,0,0.0
519098,USDCHF,1,8.5,0,1,1.0
519098,USDJPY,3,-33.010000000000005,2,1,0.3333333333333333
519317,AUDUSD,1,-16.0,1,0,0.0
519317,EURJPY,4,-13.990000000000002,3,1,0.25
519317,EURUSD,1476,-11316.7,654,822,0.556910569105691
519317,GBPJPY,78,-1207.21,43,35,0.44871794871794873
519317,GBPUSD,89,-142.04,42,47,0.5280898876404494
519317,USDCHF,1,-2.74,1,0,0.0
519317,USDJPY,25,293.01,9,16,0.64
519883,AUDUSD,1,0.8,0,1,1.0
519883,EURGBP,2,-22.66,2,0,0.0
519883,EURJPY,2,-10.45,2,0,0.0
519883,EURUSD,1923,-5745.9,994,929,0.4830993239729589
519883,GBPUSD,2,3.5,1,1,0.5
519883,USDCAD,2,-9.42,2,0,0.0
519883,USDCHF,2,-5.77,1,1,0.5
519883,USDJPY,10,-147.26,8,2,0.2
520652,AUDJPY,13,189.41,0,13,1.0
520652,AUDUSD,65,65.1,21,44,0.676923076923077
520652,CHFJPY,34,186.71,0,34,1.0
520652,EURCHF,18,-179.99,3,15,0.8333333333333334
520652,EURGBP,1,3.76,0,1,1.0
520652,EURJPY,9,-6.459999999999997,1,8,0.8888888888888888
520652,EURUSD,279,-3249.6,72,207,0.7419354838709677
520652,GBPCHF,28,-957.79,6,22,0.7857142857142857
520652,GBPJPY,58,-1283.53,13,45,0.7758620689655172
520652,GBPUSD,566,-2855.5,104,462,0.8162544169611308
520652,NZDUSD,9,41.3,1,8,0.8888888888888888
520652,USDCAD,180,319.59000000000003,26,154,0.8555555555555555
520652,USDCHF,489,-4207.52,154,335,0.6850715746421268
520652,USDJPY,269,-2662.2,92,177,0.6579925650557621
520805,EURUSD,1,0.4,0,1,1.0
520805,GBPUSD,215,-388.01,41,174,0.8093023255813954
520805,USDCHF,1,-1.29,1,0,0.0
520817,AUDCAD,1,-80.64,1,0,0.0
520817,AUDJPY,1,11.53,0,1,1.0
520817,AUDUSD,8,251.90000000000003,3,5,0.625
520817,CADJPY,2,243.55,0,2,1.0
520817,EURGBP,3,116.78,0,3,1.0
520817,EURJPY,12,-1058.01,6,6,0.5
520817,EURUSD,731,-12191.12,260,471,0.6443228454172366
520817,GBPCHF,2,-1535.27,2,0,0.0
520817,GBPJPY,9,-625.99,6,3,0.3333333333333333
520817,GBPUSD,217,-4965.7,86,131,0.6036866359447005
520817,USDCAD,6,-110.42,4,2,0.3333333333333333
520817,USDCHF,13,107.57,7,6,0.46153846153846156
520817,USDJPY,9,88.57000000000002,5,4,0.4444444444444444
520817,XAUUSD,4,89.4,2,2,0.5
520876,EURUSD,159,-669.0,39,120,0.7547169811320755
521066,AUDCAD,1,-80.28,1,0,0.0
521066,AUDNZD,50,-61.830000000000005,23,27,0.54
521066,AUDUSD,1,-108.3,1,0,0.0
521066,EURAUD,4,27.31,1,3,0.75
521066,EURCAD,2,-62.120000000000005,1,1,0.5
521066,EURCHF,2,55.23,0,2,1.0
521066,EURGBP,1,0.1,0,1,1.0
521066,EURUSD,33,451.18,13,20,0.6060606060606061
521066,GBPCHF,1,1.43,0,1,1.0
521066,GBPUSD,5,20.740000000000002,2,3,0.6
521066,NZDUSD,1,-45.6,1,0,0.0
521317,AUDUSD,8,-72.2,5,3,0.375
521317,GBPUSD,5083,-18442.34,1796,3287,0.6466653551052528
521317,USDCAD,6,0.49999999999999994,1,5,0.8333333333333334
521317,USDJPY,9,-1.7699999999999996,4,5,0.5555555555555556
521317,USDMXN,1,-0.72,1,0,0.0
521334,AUDUSD,2,-12.64,1,1,0.5
521334,EURJPY,2,0.74,0,2,1.0
521334,EURUSD,285,-65.63,61,224,0.7859649122807018
521334,GBPJPY,8,-35.83,3,5,0.625
521334,GBPUSD,17,-259.89,10,7,0.4117647058823529
521334,USDCHF,1,0.93,0,1,1.0
521334,USDJPY,5,-3.8000000000000043,2,3,0.6
521432,AUDUSD,5,-2550.0,5,0,0.0
521432,EURGBP,13,49302.03,3,10,0.7692307692307693
521432,EURUSD,9,12410.0,2,7,0.7777777777777778
521432,GBPJPY,26,-119939.23000000001,22,4,0.15384615384615385
521432,GBPUSD,63,-16150.0,40,23,0.36507936507936506
521432,USDCHF,9,7360.29,3,6,0.6666666666666666
521432,USDJPY,19,-82585.21,16,3,0.15789473684210525
521629,AUDJPY,2,-29.41,1,1,0.5
521629,AUDUSD,30,-72.2,10,20,0.6666666666666666
521629,EURUSD,976,-347.93,201,775,0.7940573770491803
521629,GBPJPY,2,-7.66,1,1,0.5
521629,GBPUSD,577,-3113.1,146,431,0.7469670710571924
521629,XAGUSD,39,-312.0,18,21,0.5384615384615384
522479,AUDUSD,4,-400.0,2,2,0.5
522479,EURGBP,51,-1656.87,21,30,0.5882352941176471
522479,EURJPY,22,18.60000000000001,7,15,0.6818181818181818
522479,EURUSD,267,-1276.7,112,155,0.5805243445692884
522479,GBPJPY,95,-1449.1200000000001,41,54,0.5684210526315789
522479,GBPUSD,178,-1372.8999999999999,64,114,0.6404494382022472
522479,NZDUSD,32,36.7,2,30,0.9375
522479,USDJPY,257,-411.55000000000007,78,179,0.6964980544747081
522479,XAGUSD,19,-96.0,13,6,0.3157894736842105
522479,XAUUSD,15,23.9,5,10,0.6666666666666666
522692,AUDUSD,6,-34.53,2,4,0.6666666666666666
522692,EURCHF,7,-32.95,3,4,0.5714285714285714
522692,EURGBP,1,6.63,0,1,1.0
522692,EURJPY,4,-71.48,1,3,0.75
522692,EURUSD,48,-467.77,17,31,0.6458333333333334
522692,GBPJPY,6,-22.039999999999992,1,5,0.8333333333333334
522692,GBPUSD,42,-224.1,15,27,0.6428571428571429
522692,NZDUSD,1,-8.0,1,0,0.0
522692,USDCAD,4,1.8399999999999936,1,3,0.75
522692,USDCHF,4,0.8899999999999997,1,3,0.75
522692,USDJPY,7,-15.299999999999999,3,4,0.5714285714285714
523113,EURUSD,90,-501.0,14,76,0.8444444444444444
523113,USDJPY,103,-4192.83,29,74,0.7184466019417476
523473,EURUSD,92,-432.0,37,55,0.5978260869565217
523473,GBPUSD,159,-1694.0,66,93,0.5849056603773585
523770,AUDUSD,10,52.69,3,7,0.7
523770,CADJPY,2,-10.35,2,0,0.0
523770,EURCAD,1,5.04,0,1,1.0
523770,EURGBP,1,0.93,0,1,1.0
523770,EURJPY,18,-48.39,9,9,0.5
523770,EURUSD,40,-44.6,15,25,0.625
523770,GBPJPY,5,-62.0,2,3,0.6
523770,GBPUSD,69,-235.95,33,36,0.5217391304347826
523770,NZDUSD,1,2.0,0,1,1.0
523770,USDCAD,20,-4.619999999999997,10,10,0.5
523770,USDJPY,35,-119.86,25,10,0.2857142857142857
523770,USDMXN,1,2.28,0,1,1.0
523770,XAGUSD,4,-29.989999999999995,3,1,0.25
523784,AUDCAD,1,-4.85,1,0,0.0
523784,AUDJPY,15,-6.08,8,7,0.4666666666666667
523784,AUDUSD,26,-11.3,11,15,0.5769230769230769
523784,CADJPY,33,-47.38,23,10,0.30303030303030304
523784,CHFJPY,4,-6.970000000000001,3,1,0.25
523784,EURAUD,8,-20.32,5,3,0.375
523784,EURCAD,3,-2.59,1,2,0.6666666666666666
523784,EURCHF,4,-2.78,3,1,0.25
523784,EURGBP,21,-31.250000000000004,13,8,0.38095238095238093
523784,EURJPY,29,-15.07,15,14,0.4827586206896552
523784,EURUSD,667,-443.4,368,299,0.4482758620689655
523784,GBPCHF,6,-34.37,3,3,0.5
523784,GBPJPY,9,-9.79,6,3,0.3333333333333333
523784,GBPUSD,369,-335.5,179,190,0.5149051490514905
523784,NZDUSD,9,-3.0,4,5,0.5555555555555556
523784,USDCAD,18,-13.07,7,11,0.6111111111111112
523784,USDCHF,14,-3.5300000000000002,6,8,0.5714285714285714
523784,USDJPY,29,-14.680000000000001,14,15,0.5172413793103449
523784,USDMXN,6,-85.71,6,0,0.0
523784,USDTRY,4,-12.29,3,1,0.25
523784,XAGUSD,6,-4.2,4,2,0.3333333333333333
523784,XAUUSD,7,-37.41,7,0,0.0
523944,AUDUSD,26,44.900000000000006,12,14,0.5384615384615384
523944,EURCHF,8,172.42,0,8,1.0
523944,EURGBP,7,-43.45,3,4,0.5714285714285714
523944,EURJPY,10,-235.38,8,2,0.2
523944,EURUSD,2913,-8916.42,1452,1461,0.5015447991761071
523944,GBPUSD,242,-1507.73,134,108,0.4462809917355372
523944,USDCAD,53,-125.97000000000001,30,23,0.4339622641509434
523944,USDCHF,65,-651.6899999999999,40,25,0.38461538461538464
523944,USDJPY,17,-188.53000000000003,13,4,0.23529411764705882
523964,EURUSD,102,-792.7,48,54,0.5294117647058824
523991,EURUSD,53,-302.5,17,36,0.6792452830188679
523991,GBPUSD,58,-711.9,25,33,0.5689655172413793
523991,NZDUSD,1,2.0,0,1,1.0
523991,USDCAD,1,31.42,0,1,1.0
523991,USDCHF,1,1.83,0,1,1.0
524166,EURUSD,178,380.02,61,117,0.6573033707865169
524174,CADJPY,1,1.94,0,1,1.0
524174,CHFJPY,1,-1.31,1,0,0.0
524174,EURUSD,60,-67.4,23,37,0.6166666666666667
524174,GBPUSD,55,-167.1,15,40,0.7272727272727273
524174,NZDUSD,2,-1.9999999999999998,1,1,0.5
524174,USDJPY,2,-5.42,2,0,0.0
544556,AUDJPY,1,5117.27,0,1,1.0
544556,AUDUSD,1,3.0,0,1,1.0
544556,EURGBP,57,24764.57,25,32,0.5614035087719298
544556,EURJPY,1,420.12,0,1,1.0
544556,EURUSD,508,-10377.2,172,336,0.6614173228346457
544556,GBPUSD,22,-10.5,7,15,0.6818181818181818
544556,USDCAD,38,-12662.5,16,22,0.5789473684210527
544556,USDCHF,43,1057.6499999999994,18,25,0.5813953488372093
544556,USDJPY,2,-214.82,2,0,0.0
544556,XAGUSD,13,1610.5,5,8,0.6153846153846154
544556,XAUUSD,1,-120.0,1,0,0.0
544680,AUDJPY,1,-16.48,1,0,0.0
544680,AUDNZD,1,0.12,0,1,1.0
544680,AUDUSD,7,5.3,3,4,0.5714285714285714
544680,EURAUD,3,-27.68,3,0,0.0
544680,EURGBP,14,-110.37,8,6,0.42857142857142855
544680,EURJPY,113,268.27,17,96,0.8495575221238938
544680,EURUSD,694,-2042.1,119,575,0.8285302593659942
544680,GBPJPY,2,39.29,0,2,1.0
544680,GBPUSD,58,-112.3,17,41,0.7068965517241379
544680,NZDUSD,8,79.6,1,7,0.875
544680,USDCAD,1,0.36,0,1,1.0
544680,USDCHF,20,-32.14,8,12,0.6
544680,USDJPY,14,-16.830000000000002,8,6,0.42857142857142855
544954,AUDUSD,18,29.9,6,12,0.6666666666666666
544954,EURGBP,4,-39.839999999999996,3,1,0.25
544954,EURJPY,11,29.820000000000007,4,7,0.6363636363636364
544954,EURUSD,19,10.699999999999992,6,13,0.6842105263157895
544954,GBPUSD,14,-60.0,8,6,0.42857142857142855
544954,NZDUSD,4,20.0,0,4,1.0
544954,USDCAD,9,-70.14,4,5,0.5555555555555556
544954,USDCHF,11,5.5299999999999905,7,4,0.36363636363636365
544954,USDJPY,22,103.91,8,14,0.6363636363636364
545144,AUDUSD,3,-36.0,1,2,0.6666666666666666
545144,CHFJPY,1,5.22,0,1,1.0
545144,EURAUD,8,-94.8,2,6,0.75
545144,EURGBP,2,21.4,0,2,1.0
545144,EURJPY,1,11.4,0,1,1.0
545144,EURUSD,46,-419.0,2,44,0.9565217391304348
545144,GBPCHF,6,-264.68,1,5,0.8333333333333334
545144,GBPJPY,14,-738.9200000000001,1,13,0.9285714285714286
545144,GBPUSD,42,-1501.0,5,37,0.8809523809523809
545144,NZDUSD,8,62.0,0,8,1.0
545144,USDCAD,6,40.8,0,6,1.0
545144,USDCHF,7,-325.13,2,5,0.7142857142857143
545144,USDJPY,14,107.31,0,14,1.0
545144,USDMXN,12,87.59,1,11,0.9166666666666666
545144,XAGUSD,2,11.0,0,2,1.0
545144,XAUUSD,19,-271.5,4,15,0.7894736842105263
545181,EURCHF,75,25.690000000000005,14,61,0.8133333333333334
545181,EURUSD,1256,-1704.1499999999999,354,902,0.7181528662420382
545181,GBPJPY,9,-23.47,6,3,0.3333333333333333
545181,USDCAD,22,5.040000000000001,10,12,0.5454545454545454
545181,USDCHF,199,-311.19,52,147,0.7386934673366834
545181,XAGUSD,1,-6.5,1,0,0.0
545310,AUDJPY,5,-77.12,5,0,0.0
545310,AUDUSD,16,236.2,5,11,0.6875
545310,CHFJPY,1,-44.78,1,0,0.0
545310,EURGBP,1,-42.74,1,0,0.0
545310,EURJPY,31,-1011.3299999999999,17,14,0.45161290322580644
545310,EURUSD,33,128.8,15,18,0.5454545454545454
545310,GBPJPY,10,-153.8,6,4,0.4
545310,GBPUSD,33,-189.8,19,14,0.42424242424242425
545310,USDCHF,11,-362.69,7,4,0.36363636363636365
545310,USDJPY,10,-423.0,6,4,0.4
545352,EURAUD,21,-231.39,6,15,0.7142857142857143
545352,EURCAD,328,-244.28000000000003,152,176,0.5365853658536586
545352,EURCHF,54,-191.55,24,30,0.5555555555555556
545352,EURGBP,44,-263.52,34,10,0.22727272727272727
545392,AUDJPY,39,-317.57,27,12,0.3076923076923077
545392,AUDUSD,94,-1203.7,49,45,0.4787234042553192
545392,EURAUD,43,43.67999999999999,22,21,0.4883720930232558
545392,EURCHF,4,-9.33,4,0,0.0
545392,EURGBP,11,-30.689999999999998,7,4,0.36363636363636365
545392,EURJPY,60,-90.74000000000001,24,36,0.6
545392,EURUSD,298,-1448.5,168,130,0.436241610738255
545392,GBPCHF,2,-3.21,1,1,0.5
545392,GBPJPY,183,-3635.98,114,69,0.3770491803278688
545392,GBPUSD,148,-2059.6,87,61,0.41216216216216217
545392,USDCAD,49,-627.02,36,13,0.2653061224489796
545392,USDCHF,90,-866.81,44,46,0.5111111111111111
545392,USDJPY,112,-919.7099999999999,74,38,0.3392857142857143
546460,AUDCAD,1,19.04,0,1,1.0
546460,AUDJPY,58,543.71,27,31,0.5344827586206896
546460,AUDUSD,136,-93.42999999999995,79,57,0.41911764705882354
546460,CHFJPY,6,-20.32,4,2,0.3333333333333333
546460,EURAUD,3,7.48,1,2,0.6666666666666666
546460,EURCHF,3,10.87,1,2,0.6666666666666666
546460,EURGBP,69,-874.6800000000001,44,25,0.36231884057971014
546460,EURJPY,69,-300.82000000000005,40,29,0.42028985507246375
546460,EURUSD,299,-1380.97,177,122,0.4080267558528428
546460,GBPCHF,5,16.75,2,3,0.6
546460,GBPJPY,3,-24.81,2,1,0.3333333333333333
546460,GBPUSD,125,-829.78,80,45,0.36
546460,NZDUSD,13,-93.0,9,4,0.3076923076923077
546460,USDCAD,10,-95.66,6,4,0.4
546460,USDCHF,12,19.959999999999994,5,7,0.5833333333333334
546460,USDJPY,89,29.47000000000007,51,38,0.42696629213483145
546460,XAGUSD,3,-39.52,3,0,0.0
546460,XAUUSD,4,5.680000000000007,3,1,0.25
546573,AUDJPY,1,-162.37,1,0,0.0
546573,AUDUSD,41,-915.5,27,14,0.34146341463414637
546573,CHFJPY,7,-81.3,4,3,0.42857142857142855
546573,EURGBP,6,-399.04,6,0,0.0
546573,EURJPY,53,577.9100000000001,22,31,0.5849056603773585
546573,EURUSD,99,-1036.9,55,44,0.4444444444444444
546573,GBPJPY,9,-139.33,6,3,0.3333333333333333
546573,GBPUSD,43,-336.9,23,20,0.46511627906976744
546573,NZDUSD,5,-301.1,4,1,0.2
546573,USDCAD,15,-339.70000000000005,9,6,0.4
546573,USDCHF,20,-113.25000000000003,6,14,0.7
546573,USDJPY,27,96.53999999999998,16,11,0.4074074074074074
546684,AUDUSD,21,-217.64999999999992,15,6,0.2857142857142857
546684,EURUSD,15,438.27,9,6,0.4
546684,GBPJPY,22,-627.28,16,6,0.2727272727272727
546684,GBPUSD,17,-308.97,11,6,0.35294117647058826
546684,NZDUSD,16,393.36,10,6,0.375
546684,USDCAD,24,-1363.39,20,4,0.16666666666666666
546684,USDCHF,15,450.4,7,8,0.5333333333333333
546684,USDJPY,21,-691.05,16,5,0.23809523809523808
547295,AUDUSD,32,-531.0,22,10,0.3125
547295,EURGBP,3,52.83,1,2,0.6666666666666666
547295,EURJPY,24,357.21,11,13,0.5416666666666666
547295,EURUSD,31,139.0,19,12,0.3870967741935484
547295,GBPJPY,20,4.770000000000024,13,7,0.35
547295,GBPUSD,37,112.0,18,19,0.5135135135135135
547295,USDCAD,28,20.590000000000003,15,13,0.4642857142857143
547295,USDCHF,12,-341.21,10,2,0.16666666666666666
547295,USDJPY,19,-173.66,10,9,0.47368421052631576
547480,AUDCAD,1,3.74,0,1,1.0
547480,AUDJPY,23,-240.16,10,13,0.5652173913043478
547480,AUDUSD,59,-256.0,30,29,0.4915254237288136
547480,CADJPY,3,3.1099999999999994,1,2,0.6666666666666666
547480,CHFJPY,14,-6.58,9,5,0.35714285714285715
547480,EURCHF,1,-1.95,1,0,0.0
547480,EURGBP,6,-87.32,3,3,0.5
547480,EURJPY,59,141.15000000000003,27,32,0.5423728813559322
547480,EURUSD,68,10.400000000000006,31,37,0.5441176470588235
547480,GBPJPY,6,-26.150000000000002,3,3,0.5
547480,GBPUSD,53,-377.6,27,26,0.49056603773584906
547480,NZDUSD,1,-37.5,1,0,0.0
547480,USDCAD,14,-134.5,9,5,0.35714285714285715
547480,USDCHF,44,35.089999999999996,19,25,0.5681818181818182
547480,USDJPY,41,11.169999999999993,22,19,0.4634146341463415
547480,XAGUSD,2,4.3,0,2,1.0
547537,AUDCAD,1,51.76,0,1,1.0
547537,AUDJPY,10,30.43,3,7,0.7
547537,AUDUSD,29,-942.4599999999999,17,12,0.41379310344827586
547537,CADJPY,5,-162.71,4,1,0.2
547537,CHFJPY,5,162.34,2,3,0.6
547537,EURAUD,7,-3.6100000000000048,3,4,0.5714285714285714
547537,EURCAD,1,2.01,0,1,1.0
547537,EURCHF,5,78.93000000000002,3,2,0.4
547537,EURGBP,8,518.83,2,6,0.75
547537,EURJPY,59,143.67,22,37,0.6271186440677966
547537,EURUSD,49,166.1,27,22,0.4489795918367347
547537,GBPCHF,11,20.679999999999996,6,5,0.45454545454545453
547537,GBPJPY,487,1064.5500000000002,106,381,0.7823408624229979
547537,GBPUSD,88,-1344.03,37,51,0.5795454545454546
547537,NZDUSD,8,-101.0,4,4,0.5
547537,USDCAD,18,-271.01,11,7,0.3888888888888889
547537,USDCHF,22,205.53000000000003,11,11,0.5
547537,USDJPY,39,-32.92000000000002,19,20,0.5128205128205128
547600,AUDUSD,8,4.380000000000003,3,5,0.625
547600,CHFJPY,2,-72.32,2,0,0.0
547600,EURCAD,2,-35.870000000000005,2,0,0.0
547600,EURGBP,3,31.88,1,2,0.6666666666666666
547600,EURUSD,31,91.98,4,27,0.8709677419354839
547600,GBPUSD,23,25.499999999999993,4,19,0.8260869565217391
547600,NZDUSD,4,-55.65,4,0,0.0
547600,USDCAD,18,164.7,0,18,1.0
547600,USDCHF,37,-310.57,4,33,0.8918918918918919
547600,USDJPY,9,-27.07,4,5,0.5555555555555556
547600,USDTRY,1,-10.34,1,0,0.0
547600,XAGUSD,15,5.729999999999958,5,10,0.6666666666666666
547600,XAUUSD,13,-95.49000000000004,5,8,0.6153846153846154
547616,AUDJPY,6,-719.7199999999999,3,3,0.5
547616,AUDUSD,53,-3007.0,6,47,0.8867924528301887
547616,CHFJPY,6,204.81,1,5,0.8333333333333334
547616,EURGBP,2,-219.52999999999997,1,1,0.5
547616,EURJPY,59,106.37999999999997,11,48,0.8135593220338984
547616,EURUSD,81,-507.6,14,67,0.8271604938271605
547616,GBPJPY,2,-74.78,1,1,0.5
547616,GBPUSD,23,-2283.0,7,16,0.6956521739130435
547616,USDCAD,5,135.97,1,4,0.8
547616,USDCHF,3,124.95000000000002,1,2,0.6666666666666666
547616,USDJPY,4,432.67999999999995,0,4,1.0
547622,EURUSD,1331,-4725.79,132,1199,0.9008264462809917
547622,GBPUSD,3,1.4,0,3,1.0
547730,AUDJPY,3,-18.39,2,1,0.3333333333333333
547730,AUDUSD,44,22.900000000000006,22,22,0.5
547730,CHFJPY,6,22.79,1,5,0.8333333333333334
547730,EURAUD,1,-9.58,1,0,0.0
547730,EURGBP,2,-19.63,2,0,0.0
547730,EURJPY,43,185.65,15,28,0.6511627906976745
547730,EURUSD,49,115.9,21,28,0.5714285714285714
547730,GBPUSD,47,-100.10000000000002,26,21,0.44680851063829785
547730,NZDUSD,2,7.5,0,2,1.0
547730,USDCAD,14,-169.31,11,3,0.21428571428571427
547730,USDCHF,30,41.51999999999997,11,19,0.6333333333333333
547730,USDJPY,21,120.22,8,13,0.6190476190476191
548047,AUDCAD,1,3.34,0,1,1.0
548047,AUDJPY,2,-69.03,2,0,0.0
548047,AUDNZD,2,-8.67,2,0,0.0
548047,AUDUSD,6,24.8,4,2,0.3333333333333333
548047,CADJPY,2,-52.379999999999995,2,0,0.0
548047,CHFJPY,1,-11.68,1,0,0.0
548047,EURCAD,3,-36.28,2,1,0.3333333333333333
548047,EURCHF,1,-117.36,1,0,0.0
548047,EURGBP,4,-12.09,2,2,0.5
548047,EURJPY,10,-71.93,7,3,0.3
548047,EURUSD,19,49.5,11,8,0.42105263157894735
548047,GBPCHF,3,186.45,1,2,0.6666666666666666
548047,GBPJPY,13,-429.83000000000004,8,5,0.38461538461538464
548047,GBPUSD,7,173.4,2,5,0.7142857142857143
548047,NZDUSD,4,-144.0,2,2,0.5
548047,USDCAD,15,-102.25,9,6,0.4
548047,USDCHF,7,9.080000000000002,2,5,0.7142857142857143
548047,USDJPY,3,55.699999999999996,2,1,0.3333333333333333
548047,USDMXN,1,6.51,0,1,1.0
548047,XAGUSD,1,1.8,0,1,1.0
548047,XAUUSD,1,11.28,0,1,1.0
548060,AUDJPY,38,-77.63,26,12,0.3157894736842105
548060,AUDUSD,117,-231.7,67,50,0.42735042735042733
548060,CHFJPY,7,71.72,2,5,0.7142857142857143
548060,EURGBP,3,14.329999999999998,0,3,1.0
548060,EURJPY,259,-576.07,126,133,0.5135135135135135
548060,EURUSD,252,-439.3,124,128,0.5079365079365079
548060,GBPJPY,119,-405.62,65,54,0.453781512605042
548060,GBPUSD,320,-960.4,172,148,0.4625
548060,NZDUSD,13,6.5,5,8,0.6153846153846154
548060,USDCAD,26,-35.86,18,8,0.3076923076923077
548060,USDCHF,56,25.009999999999994,30,26,0.4642857142857143
548060,USDJPY,97,-26.69000000000001,48,49,0.5051546391752577
548078,AUDCAD,2,2.26,0,2,1.0
548078,AUDJPY,13,-97.92,6,7,0.5384615384615384
548078,AUDNZD,1,0.65,0,1,1.0
548078,AUDUSD,150,-732.75,63,87,0.58
548078,CHFJPY,7,31.11,2,5,0.7142857142857143
548078,EURAUD,1,3.32,0,1,1.0
548078,EURCHF,1,-2.38,1,0,0.0
548078,EURGBP,8,-139.69,4,4,0.5
548078,EURJPY,107,252.13,39,68,0.6355140186915887
548078,EURUSD,263,-698.9399999999999,92,171,0.6501901140684411
548078,GBPJPY,4,14.27,0,4,1.0
548078,GBPUSD,145,-588.18,43,102,0.7034482758620689
548078,NZDUSD,5,-170.81,4,1,0.2
548078,USDCAD,17,237.01,7,10,0.5882352941176471
548078,USDCHF,37,-221.44,15,22,0.5945945945945946
548078,USDJPY,55,-215.11999999999995,28,27,0.4909090909090909
548089,AUDJPY,11,-63.75,4,7,0.6363636363636364
548089,AUDUSD,7,22.900000000000002,1,6,0.8571428571428571
548089,CADJPY,1,1.97,0,1,1.0
548089,CHFJPY,1,3.56,0,1,1.0
548089,EURCHF,2,-2.54,2,0,0.0
548089,EURGBP,4,-16.659999999999997,1,3,0.75
548089,EURJPY,34,-380.89,12,22,0.6470588235294118
548089,EURUSD,115,-1180.73,36,79,0.6869565217391305
548089,GBPCHF,3,32.83,0,3,1.0
548089,GBPJPY,34,-1692.1,12,22,0.6470588235294118
548089,GBPUSD,56,122.67,13,43,0.7678571428571429
548089,USDCAD,10,-37.440000000000005,6,4,0.4
548089,USDCHF,8,6.279999999999999,4,4,0.5
548089,USDJPY,12,-13.65,2,10,0.8333333333333334
548286,AUDNZD,4,28.939999999999998,1,3,0.75
548286,AUDUSD,24,324.98,4,20,0.8333333333333334
548286,CHFJPY,1,-9.2,1,0,0.0
548286,EURGBP,2,25.49,0,2,1.0
548286,EURJPY,33,-459.46999999999997,13,20,0.6060606060606061
548286,EURUSD,113,-1241.4,29,84,0.7433628318584071
548286,GBPJPY,11,412.57,2,9,0.8181818181818182
548286,GBPUSD,273,-410.25,66,207,0.7582417582417582
548286,NZDUSD,2,-26.0,2,0,0.0
548286,USDCAD,11,-15.699999999999996,4,7,0.6363636363636364
548286,USDCHF,7,86.73,1,6,0.8571428571428571
548286,USDJPY,3,72.07,0,3,1.0
548423,AUDCAD,1,-4.35,1,0,0.0
548423,AUDJPY,6,-536.1,4,2,0.3333333333333333
548423,AUDUSD,28,-52.18999999999999,15,13,0.4642857142857143
548423,CADJPY,1,-9.17,1,0,0.0
548423,CHFJPY,10,-414.92,5,5,0.5
548423,EURGBP,7,-392.45000000000005,7,0,0.0
548423,EURJPY,21,498.73,7,14,0.6666666666666666
548423,EURUSD,25,-1133.7,17,8,0.32
548423,GBPJPY,5,8.569999999999999,2,3,0.6
548423,GBPUSD,30,-854.13,19,11,0.36666666666666664
548423,NZDUSD,1,6.64,0,1,1.0
548423,USDCAD,12,-266.14,10,2,0.16666666666666666
548423,USDCHF,23,328.26,12,11,0.4782608695652174
548423,USDJPY,26,778.15,12,14,0.5384615384615384
548473,AUDUSD,3,6.3,0,3,1.0
548473,EURUSD,440,-48.269999999999996,183,257,0.5840909090909091
548473,USDCHF,1,-2.68,1,0,0.0
548752,AUDUSD,2,-21.0,2,0,0.0
548752,EURUSD,225,-573.0,87,138,0.6133333333333333
548752,USDCAD,3,0.4199999999999875,1,2,0.6666666666666666
548752,USDJPY,2,-22.32,2,0,0.0
549056,AUDJPY,24,-173.88,16,8,0.3333333333333333
549056,AUDUSD,35,-241.4,23,12,0.34285714285714286
549056,CHFJPY,4,42.44999999999998,1,3,0.75
549056,EURAUD,1,2.0,0,1,1.0
549056,EURGBP,2,-243.63,2,0,0.0
549056,EURJPY,65,-314.71,40,25,0.38461538461538464
549056,EURUSD,42,-410.8,23,19,0.4523809523809524
549056,GBPJPY,38,43.01,20,18,0.47368421052631576
549056,GBPUSD,37,-405.8,20,17,0.4594594594594595
549056,NZDUSD,5,-13.4,4,1,0.2
549056,USDCAD,6,-81.8,3,3,0.5
549056,USDCHF,7,-35.63999999999999,4,3,0.42857142857142855
549056,USDJPY,16,-50.230000000000025,8,8,0.5
549056,USDMXN,1,7.07,0,1,1.0
549233,AUDJPY,4,-0.98,3,1,0.25
549233,AUDUSD,63,-45.2,32,31,0.49206349206349204
549233,CHFJPY,2,-3.06,2,0,0.0
549233,EURGBP,3,-17.28,3,0,0.0
549233,EURJPY,51,2.5199999999999996,29,22,0.43137254901960786
549233,EURUSD,160,-83.3,83,77,0.48125
549233,GBPUSD,47,-90.1,27,20,0.425531914893617
549233,USDCAD,9,-5.630000000000001,4,5,0.5555555555555556
549233,USDCHF,17,11.55,8,9,0.5294117647058824
549233,USDJPY,23,45.74,8,15,0.6521739130434783
549283,AUDCAD,3,-52.85,3,0,0.0
549283,AUDJPY,2,259.14,0,2,1.0
549283,AUDUSD,20,-570.0,15,5,0.25
549283,CADJPY,1,52.69,0,1,1.0
549283,CHFJPY,5,152.41000000000003,2,3,0.6
549283,EURAUD,1,-47.32,1,0,0.0
549283,EURGBP,6,-850.26,6,0,0.0
549283,EURJPY,25,240.18999999999997,12,13,0.52
549283,EURUSD,32,-491.1,21,11,0.34375
549283,GBPCHF,2,-322.98,2,0,0.0
549283,GBPJPY,5,-23.980000000000004,3,2,0.4
549283,GBPUSD,19,576.15,12,7,0.3684210526315789
549283,NZDUSD,4,-43.98,3,1,0.25
549283,USDCAD,8,183.93,5,3,0.375
549283,USDCHF,16,216.26999999999992,9,7,0.4375
549283,USDJPY,18,-74.49000000000001,9,9,0.5
549283,XAUUSD,4,-88.58,3,1,0.25
549482,AUDCAD,2,-40.32,2,0,0.0
549482,AUDJPY,20,-405.38,11,9,0.45
549482,AUDUSD,29,-333.8,15,14,0.4827586206896552
549482,CADJPY,1,11.15,0,1,1.0
549482,CHFJPY,5,-219.17000000000002,4,1,0.2
549482,EURAUD,1,-28.31,1,0,0.0
549482,EURGBP,7,-154.51,6,1,0.14285714285714285
549482,EURJPY,39,198.17,16,23,0.5897435897435898
549482,EURUSD,81,-875.26,48,33,0.4074074074074074
549482,GBPJPY,3,0.8200000000000003,2,1,0.3333333333333333
549482,GBPUSD,32,19.049999999999997,10,22,0.6875
549482,NZDUSD,5,-65.25999999999999,3,2,0.4
549482,USDCAD,11,-144.38,6,5,0.45454545454545453
549482,USDCHF,19,132.03,6,13,0.6842105263157895
549482,USDJPY,27,89.28999999999999,10,17,0.6296296296296297
550339,AUDJPY,7,123.85,2,5,0.7142857142857143
550339,AUDUSD,32,-179.76,13,19,0.59375
550339,CADJPY,1,-75.63,1,0,0.0
550339,EURCAD,5,244.8,0,5,1.0
550339,EURCHF,14,-64.86,11,3,0.21428571428571427
550339,EURGBP,5,8.260000000000002,2,3,0.6
550339,EURJPY,17,-1143.78,8,9,0.5294117647058824
550339,EURUSD,112,-516.7,31,81,0.7232142857142857
550339,GBPCHF,2,-21.61,2,0,0.0
550339,GBPJPY,15,-428.75,7,8,0.5333333333333333
550339,GBPUSD,92,-839.79,46,46,0.5
550339,NZDUSD,9,-216.9,6,3,0.3333333333333333
550339,USDCAD,28,-50.03,15,13,0.4642857142857143
550339,USDCHF,29,49.94,15,14,0.4827586206896552
550339,USDJPY,27,22.570000000000004,10,17,0.6296296296296297
550339,XAUUSD,1,15.34,0,1,1.0
550737,AUDJPY,23,65.64999999999992,3,20,0.8695652173913043
550737,AUDUSD,21,-722.0,5,16,0.7619047619047619
550737,EURAUD,7,647.61,0,7,1.0
550737,EURGBP,9,-46.65000000000002,3,6,0.6666666666666666
550737,EURJPY,381,13652.01,41,340,0.8923884514435696
550737,EURUSD,478,-27182.0,101,377,0.7887029288702929
550737,GBPCHF,1,38.81,0,1,1.0
550737,GBPJPY,31,-2409.97,6,25,0.8064516129032258
550737,GBPUSD,812,22220.0,142,670,0.8251231527093597
550737,NZDUSD,7,46.0,2,5,0.7142857142857143
550737,USDCAD,19,404.09999999999974,3,16,0.8421052631578947
550737,USDCHF,1,11.2,0,1,1.0
550737,USDJPY,25,1355.11,2,23,0.92
550754,EURJPY,1,-3.45,1,0,0.0
550754,EURUSD,179,-101.09,59,120,0.6703910614525139
550754,GBPJPY,42,-208.15999999999997,10,32,0.7619047619047619
550754,GBPUSD,11,58.0,3,8,0.7272727272727273
550754,USDCHF,2,0.46,1,1,0.5
550754,USDJPY,5,-48.18,2,3,0.6
550754,XAUUSD,12,-343.7,7,5,0.4166666666666667
550871,AUDJPY,19,-327.19,15,4,0.21052631578947367
550871,AUDUSD,182,-409.67,88,94,0.5164835164835165
550871,CHFJPY,2,-14.61,2,0,0.0
550871,EURAUD,4,-46.52,4,0,0.0
550871,EURJPY,21,95.30000000000001,11,10,0.47619047619047616
550871,EURUSD,24,-166.3,14,10,0.4166666666666667
550871,GBPJPY,8,-68.55,5,3,0.375
550871,GBPUSD,21,-176.6,12,9,0.42857142857142855
550871,NZDUSD,1,-25.0,1,0,0.0
550871,USDCAD,4,-44.09,3,1,0.25
550871,USDCHF,6,28.659999999999997,2,4,0.6666666666666666
550871,USDJPY,11,-41.14000000000001,5,6,0.5454545454545454
550871,XAGUSD,5,-1.5,3,2,0.4
550871,XAUUSD,1,-18.2,1,0,0.0
550958,EURUSD,154,-491.8,87,67,0.43506493506493504
550958,GBPUSD,30,-129.0,16,14,0.4666666666666667
550958,USDCHF,46,-301.69,33,13,0.2826086956521739
550958,USDJPY,29,-256.37,15,14,0.4827586206896552
551121,AUDJPY,36,-55.870000000000005,20,16,0.4444444444444444
551121,AUDNZD,1,-2.87,1,0,0.0
551121,AUDUSD,101,-78.6,52,49,0.48514851485148514
551121,CADJPY,2,-11.09,2,0,0.0
551121,CHFJPY,26,-39.33,17,9,0.34615384615384615
551121,EURGBP,9,-85.42,7,2,0.2222222222222222
551121,EURJPY,67,-150.38,38,29,0.43283582089552236
551121,EURUSD,125,-75.45,60,65,0.52
551121,GBPUSD,104,-99.17,55,49,0.47115384615384615
551121,NZDUSD,9,-21.42,6,3,0.3333333333333333
551121,USDCAD,14,-66.5,10,4,0.2857142857142857
551121,USDCHF,56,116.63,23,33,0.5892857142857143
551121,USDJPY,66,104.17,30,36,0.5454545454545454
551221,EURUSD,139,-132.1,94,45,0.3237410071942446
551332,AUDJPY,8,-78.79,3,5,0.625
551332,AUDUSD,18,-38.9,12,6,0.3333333333333333
551332,CHFJPY,5,0.9699999999999998,1,4,0.8
551332,EURGBP,4,-52.949999999999996,3,1,0.25
551332,EURJPY,17,12.999999999999996,9,8,0.47058823529411764
551332,EURUSD,24,-174.9,14,10,0.4166666666666667
551332,GBPCHF,1,-5.49,1,0,0.0
551332,GBPJPY,6,-24.959999999999997,4,2,0.3333333333333333
551332,GBPUSD,10,-8.6,6,4,0.4
551332,NZDUSD,1,-3.0,1,0,0.0
551332,USDCAD,1,-5.14,1,0,0.0
551332,USDCHF,9,15.5,3,6,0.6666666666666666
551332,USDJPY,8,-3.5100000000000007,4,4,0.5
551570,EURUSD,59,-114.5,30,29,0.4915254237288136
551570,GBPJPY,16,61.479999999999976,5,11,0.6875
551570,GBPUSD,39,-52.1,23,16,0.41025641025641024
551570,USDCHF,2,-8.040000000000001,2,0,0.0
551570,USDJPY,10,9.47,6,4,0.4
551571,AUDUSD,6,-18.0,3,3,0.5
551571,EURJPY,2,3.3099999999999996,0,2,1.0
551571,EURUSD,1957,-5535.9,654,1303,0.6658150229943791
551571,GBPJPY,1,1.11,0,1,1.0
551571,GBPUSD,6,-4.5,2,4,0.6666666666666666
551571,NZDUSD,4,5.5,1,3,0.75
551571,USDCAD,2,-1.9400000000000013,1,1,0.5
551571,USDCHF,2,11.85,1,1,0.5
551571,USDJPY,11,-16.060000000000002,4,7,0.6363636363636364
551576,AUDCAD,1,-72.54,1,0,0.0
551576,AUDJPY,47,-909.01,27,20,0.425531914893617
551576,AUDUSD,85,-2799.5,49,36,0.4235294117647059
551576,CADJPY,2,-166.1,2,0,0.0
551576,CHFJPY,8,-123.03,3,5,0.625
551576,EURGBP,5,-563.81,4,1,0.2
551576,EURJPY,162,2847.2200000000003,79,83,0.5123456790123457
551576,EURUSD,120,-350.0,59,61,0.5083333333333333
551576,GBPJPY,143,-753.92,82,61,0.42657342657342656
551576,GBPUSD,136,-668.0,71,65,0.47794117647058826
551576,NZDUSD,21,-769.5,12,9,0.42857142857142855
551576,USDCAD,13,-330.15,6,7,0.5384615384615384
551576,USDCHF,15,769.04,3,12,0.8
551576,USDJPY,54,1199.88,16,38,0.7037037037037037
551683,AUDJPY,4,-6.62,3,1,0.25
551683,AUDUSD,189,-318.36,124,65,0.3439153439153439
551683,CADJPY,1,-3.22,1,0,0.0
551683,CHFJPY,7,-29.61,7,0,0.0
551683,EURAUD,6,-7.359999999999999,5,1,0.16666666666666666
551683,EURCAD,10,2.699999999999999,5,5,0.5
551683,EURCHF,56,-111.56,41,15,0.26785714285714285
551683,EURGBP,54,-117.95,41,13,0.24074074074074073
551683,EURJPY,121,-27.770000000000003,78,43,0.35537190082644626
551683,EURUSD,264,-253.95000000000002,166,98,0.3712121212121212
551683,GBPCHF,4,2.5600000000000005,2,2,0.5
551683,GBPJPY,8,-18.78,5,3,0.375
551683,GBPUSD,191,-408.23,134,57,0.29842931937172773
551683,NZDUSD,42,-35.24,30,12,0.2857142857142857
551683,USDCAD,99,-32.160000000000004,60,39,0.3939393939393939
551683,USDCHF,93,-209.07,73,20,0.21505376344086022
551683,USDJPY,140,-5.439999999999999,86,54,0.38571428571428573
551683,XAGUSD,4,-18.13,4,0,0.0
551683,XAUUSD,1,-5.27,1,0,0.0
551922,AUDJPY,51,-56.10999999999999,30,21,0.4117647058823529
551922,AUDUSD,153,-154.33,90,63,0.4117647058823529
551922,CADJPY,4,-13.59,2,2,0.5
551922,CHFJPY,35,-62.72,26,9,0.2571428571428571
551922,EURAUD,3,-5.41,2,1,0.3333333333333333
551922,EURCHF,4,2.67,3,1,0.25
551922,EURGBP,9,-72.17,6,3,0.3333333333333333
551922,EURJPY,127,-4.540000000000009,61,66,0.5196850393700787
551922,EURUSD,148,-17.999999999999996,70,78,0.527027027027027
551922,GBPJPY,1,-7.81,1,0,0.0
551922,GBPUSD,115,-129.6,65,50,0.43478260869565216
551922,NZDUSD,31,-11.930000000000001,17,14,0.45161290322580644
551922,USDCAD,24,-12.84,13,11,0.4583333333333333
551922,USDCHF,48,-17.71,29,19,0.3958333333333333
551922,USDJPY,62,70.61,31,31,0.5
552076,AUDJPY,11,113.9,4,7,0.6363636363636364
552076,AUDUSD,116,-703.31,62,54,0.46551724137931033
552076,CHFJPY,6,-21.97,5,1,0.16666666666666666
552076,EURAUD,3,-53.29,3,0,0.0
552076,EURGBP,8,-77.64,7,1,0.125
552076,EURJPY,23,49.89999999999999,10,13,0.5652173913043478
552076,EURUSD,51,-806.5,38,13,0.2549019607843137
552076,GBPJPY,3,4.779999999999999,0,3,1.0
552076,GBPUSD,26,-190.3,17,9,0.34615384615384615
552076,NZDUSD,1,7.2,0,1,1.0
552076,USDCAD,14,-110.0,12,2,0.14285714285714285
552076,USDCHF,22,-19.230000000000004,12,10,0.45454545454545453
552076,USDJPY,9,15.87,5,4,0.4444444444444444
552363,AUDUSD,134,-2036.26,66,68,0.5074626865671642
552363,CHFJPY,2,8.299999999999997,1,1,0.5
552363,EURCHF,1,49.1,0,1,1.0
552363,EURUSD,22,-137.0,12,10,0.45454545454545453
552363,GBPUSD,8,-131.0,5,3,0.375
552363,USDCAD,9,-46.910000000000004,5,4,0.4444444444444444
552363,USDCHF,7,19.82,3,4,0.5714285714285714
552363,USDJPY,15,-51.210000000000015,11,4,0.26666666666666666
552369,AUDJPY,6,-19.83,2,4,0.6666666666666666
552369,AUDUSD,48,-72.0,28,20,0.4166666666666667
552369,CHFJPY,7,-11.030000000000001,3,4,0.5714285714285714
552369,EURCHF,1,-0.87,1,0,0.0
552369,EURJPY,26,-18.359999999999996,10,16,0.6153846153846154
552369,EURUSD,30,-203.6,21,9,0.3
552369,GBPUSD,32,-13.5,18,14,0.4375
552369,NZDUSD,2,-2.9,2,0,0.0
552369,USDCAD,8,-39.51,8,0,0.0
552369,USDCHF,6,-15.510000000000007,3,3,0.5
552369,USDJPY,9,17.72,5,4,0.4444444444444444
552370,AUDUSD,88,-646.2,41,47,0.5340909090909091
552370,EURUSD,716,-1754.7099999999998,242,474,0.6620111731843575
552370,GBPJPY,29,-117.60000000000001,10,19,0.6551724137931034
552370,GBPUSD,69,-296.7,27,42,0.6086956521739131
552370,USDJPY,88,-493.78,45,43,0.48863636363636365
552370,XAGUSD,80,-1328.65,46,34,0.425
552370,XAUUSD,4,-8.2,2,2,0.5
552440,AUDCAD,8,-0.4999999999999991,4,4,0.5
552440,AUDJPY,7,-96.06,6,1,0.14285714285714285
552440,AUDNZD,3,-11.010000000000002,3,0,0.0
552440,AUDUSD,16,-393.34,12,4,0.25
552440,CADJPY,9,11.73,5,4,0.4444444444444444
552440,CHFJPY,8,-72.58000000000001,6,2,0.25
552440,EURAUD,14,-14.419999999999998,10,4,0.2857142857142857
552440,EURCAD,7,20.089999999999996,2,5,0.7142857142857143
552440,EURCHF,6,-38.05,6,0,0.0
552440,EURGBP,102,-54.370000000000005,47,55,0.5392156862745098
552440,EURJPY,16,-61.22999999999999,6,10,0.625
552440,EURUSD,30,-216.75,15,15,0.5
552440,GBPCHF,5,40.54,2,3,0.6
552440,GBPJPY,8,-25.0,6,2,0.25
552440,GBPUSD,23,-91.37,16,7,0.30434782608695654
552440,NZDUSD,8,21.5,2,6,0.75
552440,USDCAD,17,-238.15,12,5,0.29411764705882354
552440,USDCHF,14,-65.27,9,5,0.35714285714285715
552440,USDJPY,8,75.73,3,5,0.625
552440,USDTRY,2,-0.8799999999999999,2,0,0.0
552609,AUDCAD,5,74.81,1,4,0.8
552609,AUDJPY,32,35.279999999999994,9,23,0.71875
552609,AUDUSD,59,-10.049999999999994,17,42,0.711864406779661
552609,EURAUD,30,284.01,9,21,0.7
552609,EURCAD,44,-340.09000000000003,19,25,0.5681818181818182
552609,EURCHF,10,59.800000000000004,1,9,0.9
552609,EURGBP,13,10.48,5,8,0.6153846153846154
552609,EURJPY,39,-281.0,12,27,0.6923076923076923
552609,EURUSD,121,-1407.48,33,88,0.7272727272727273
552609,GBPCHF,6,-60.199999999999996,2,4,0.6666666666666666
552609,GBPJPY,17,-472.24,7,10,0.5882352941176471
552609,GBPUSD,46,-633.8299999999999,18,28,0.6086956521739131
552609,NZDUSD,32,106.1,10,22,0.6875
552609,USDCAD,43,-349.97,15,28,0.6511627906976745
552609,USDCHF,39,-206.54000000000002,9,30,0.7692307692307693
552609,USDJPY,26,-97.60999999999999,8,18,0.6923076923076923
552630,AUDJPY,2,0.64,0,2,1.0
552630,AUDUSD,24,-144.45,16,8,0.3333333333333333
552630,EURGBP,1,14.97,0,1,1.0
552630,EURJPY,1,-7.4,1,0,0.0
552630,EURUSD,253,-786.43,162,91,0.35968379446640314
552630,GBPJPY,10,40.330000000000005,5,5,0.5
552630,GBPUSD,125,-387.52000000000004,86,39,0.312
552630,NZDUSD,8,-46.14,6,2,0.25
552630,USDCAD,2,-23.28,2,0,0.0
552630,USDCHF,18,-58.07,14,4,0.2222222222222222
552630,USDJPY,29,-170.23000000000002,18,11,0.3793103448275862
552654,AUDJPY,54,-108.21999999999998,29,25,0.46296296296296297
552654,AUDNZD,7,-7.24,5,2,0.2857142857142857
552654,AUDUSD,159,-277.5,82,77,0.48427672955974843
552654,CADJPY,4,19.32,1,3,0.75
552654,CHFJPY,19,-134.77999999999997,11,8,0.42105263157894735
552654,EURCHF,25,43.449999999999996,11,14,0.56
552654,EURGBP,54,-230.43,29,25,0.46296296296296297
552654,EURJPY,70,-100.13,30,40,0.5714285714285714
552654,EURUSD,118,-326.17,59,59,0.5
552654,GBPCHF,2,6.49,1,1,0.5
552654,GBPJPY,28,-19.379999999999992,14,14,0.5
552654,GBPUSD,84,-38.46000000000001,41,43,0.5119047619047619
552654,NZDUSD,22,-81.5,16,6,0.2727272727272727
552654,USDCAD,34,146.45999999999998,17,17,0.5
552654,USDCHF,24,-66.49,13,11,0.4583333333333333
552654,USDJPY,52,66.84,24,28,0.5384615384615384
552654,XAUUSD,2,6.860000000000001,1,1,0.5
552721,GBPJPY,2,-36.41,2,0,0.0
552721,GBPUSD,480,-2154.2,334,146,0.30416666666666664
552721,USDCAD,3,-44.22,3,0,0.0
552721,USDCHF,1,-5.54,1,0,0.0
552788,AUDJPY,4,-0.9400000000000002,3,1,0.25
552788,AUDNZD,2,-6.17,2,0,0.0
552788,AUDUSD,27,-459.1,18,9,0.3333333333333333
552788,CHFJPY,6,-13.959999999999999,4,2,0.3333333333333333
552788,EURAUD,1,-2.65,1,0,0.0
552788,EURGBP,1,2.27,0,1,1.0
552788,EURJPY,10,-41.94999999999995,5,5,0.5
552788,EURUSD,12,-284.9,9,3,0.25
552788,GBPCHF,3,-6.42,2,1,0.3333333333333333
552788,GBPJPY,9,-325.32,6,3,0.3333333333333333
552788,GBPUSD,22,-202.5,10,12,0.5454545454545454
552788,NZDUSD,5,-366.0,5,0,0.0
552788,USDCAD,6,-119.35000000000002,4,2,0.3333333333333333
552788,USDCHF,9,-556.23,6,3,0.3333333333333333
552788,USDJPY,7,16.43,4,3,0.42857142857142855
552788,USDMXN,1,-11.33,1,0,0.0
552976,AUDJPY,34,83.49000000000001,8,26,0.7647058823529411
552976,AUDUSD,310,-3044.07,116,194,0.6258064516129033
552976,EURCHF,20,-195.11,7,13,0.65
552976,EURGBP,54,-139.10999999999999,24,30,0.5555555555555556
552976,EURUSD,739,-2152.63,279,460,0.6224627875507442
552976,GBPJPY,107,-750.6500000000001,46,61,0.5700934579439252
552976,GBPUSD,111,-795.74,52,59,0.5315315315315315
552976,USDCAD,585,522.88,209,376,0.6427350427350428
552976,USDCHF,185,-1498.78,76,109,0.5891891891891892
552976,USDJPY,325,78.72999999999996,108,217,0.6676923076923077
553128,AUDJPY,9,2267.4400000000005,5,4,0.4444444444444444
553128,AUDUSD,62,-17364.77,35,27,0.43548387096774194
553128,CHFJPY,1,566.77,0,1,1.0
553128,EURJPY,38,-20141.800000000003,22,16,0.42105263157894735
553128,EURUSD,153,-12600.53,77,76,0.49673202614379086
553128,GBPUSD,77,6627.5,36,41,0.5324675324675324
553128,NZDUSD,1,1350.0,0,1,1.0
553128,USDCAD,12,1143.3300000000002,6,6,0.5
553128,USDCHF,5,617.5,4,1,0.2
553128,USDJPY,12,253.64,6,6,0.5
553369,AUDJPY,15,-625.98,9,6,0.4
553369,AUDNZD,3,-85.72,2,1,0.3333333333333333
553369,AUDUSD,101,-2117.73,50,51,0.504950495049505
553369,CADJPY,1,43.75,0,1,1.0
553369,CHFJPY,1,-0.73,1,0,0.0
553369,EURAUD,3,-90.57,1,2,0.6666666666666666
553369,EURGBP,5,-68.88,2,3,0.6
553369,EURJPY,15,-1269.74,10,5,0.3333333333333333
553369,EURUSD,60,-808.57,23,37,0.6166666666666667
553369,GBPJPY,1,-64.67,1,0,0.0
553369,GBPUSD,12,-490.09999999999997,10,2,0.16666666666666666
553369,NZDUSD,9,22.949999999999996,3,6,0.6666666666666666
553369,USDCAD,1,0.81,0,1,1.0
553369,USDCHF,7,19.979999999999997,3,4,0.5714285714285714
553369,USDJPY,17,157.83,5,12,0.7058823529411765
553517,AUDJPY,2,-17.54,1,1,0.5
553517,AUDUSD,19,524.0,5,14,0.7368421052631579
553517,CHFJPY,4,51.86,0,4,1.0
553517,EURAUD,2,4.890000000000001,1,1,0.5
553517,EURGBP,1,4.33,0,1,1.0
553517,EURJPY,18,798.9300000000001,3,15,0.8333333333333334
553517,EURUSD,18,428.27,4,14,0.7777777777777778
553517,GBPJPY,3,9.32,1,2,0.6666666666666666
553517,GBPUSD,22,829.5,8,14,0.6363636363636364
553517,NZDUSD,9,580.5,0,9,1.0
553517,USDCAD,8,-188.62,2,6,0.75
553517,USDCHF,4,44.63,0,4,1.0
553517,USDJPY,18,-1202.47,7,11,0.6111111111111112
553517,XAUUSD,5,-411.06,4,1,0.2
553593,AUDJPY,10,13.17999999999999,4,6,0.6
553593,AUDUSD,60,-610.0,36,24,0.4
553593,CHFJPY,2,-94.51,1,1,0.5
553593,EURGBP,1,-1.6,1,0,0.0
553593,EURJPY,27,-205.31,11,16,0.5925925925925926
553593,EURUSD,41,30.8,19,22,0.5365853658536586
553593,GBPJPY,1,-27.76,1,0,0.0
553593,GBPUSD,52,-805.0,23,29,0.5576923076923077
553593,USDCAD,3,-131.04999999999998,1,2,0.6666666666666666
553593,USDCHF,3,-43.39,3,0,0.0
553593,USDJPY,5,16.04,2,3,0.6
553769,AUDUSD,1,3.0,0,1,1.0
553769,EURUSD,90,-3883.0,7,83,0.9222222222222223
553769,GBPUSD,87,1581.0,6,81,0.9310344827586207
553769,USDJPY,17,81.03999999999999,1,16,0.9411764705882353
553781,EURCAD,1,2.79,0,1,1.0
553781,EURUSD,161,-2618.52,32,129,0.8012422360248447
553781,GBPUSD,63,274.07,9,54,0.8571428571428571
553781,USDJPY,60,238.73999999999995,7,53,0.8833333333333333
553833,AUDJPY,4,-2.220446049250313e-16,2,2,0.5
553833,AUDUSD,11,-37.9,11,0,0.0
553833,CHFJPY,1,-3.89,1,0,0.0
553833,EURAUD,2,4.08,1,1,0.5
553833,EURGBP,4,-1.1999999999999993,2,2,0.5
553833,EURJPY,24,-20.77,14,10,0.4166666666666667
553833,EURUSD,28,53.620000000000005,15,13,0.4642857142857143
553833,GBPJPY,2,-4.63,2,0,0.0
553833,GBPUSD,20,-14.899999999999999,14,6,0.3
553833,NZDUSD,2,-3.62,2,0,0.0
553833,USDCAD,3,-3.7499999999999996,2,1,0.3333333333333333
553833,USDCHF,2,0.5,1,1,0.5
553833,USDJPY,6,-2.2800000000000002,4,2,0.3333333333333333
553833,XAUUSD,1,-2.71,1,0,0.0
553851,EURUSD,215,1744.15,61,154,0.7162790697674418
553851,GBPJPY,6,-4317.88,4,2,0.3333333333333333
553851,GBPUSD,725,-43332.3,260,465,0.6413793103448275
553851,USDJPY,7,80.60000000000002,2,5,0.7142857142857143
553962,AUDJPY,3,46.86,1,2,0.6666666666666666
553962,AUDUSD,20,-511.0,16,4,0.2
553962,CHFJPY,1,-171.36,1,0,0.0
553962,EURJPY,55,284.91999999999996,28,27,0.4909090909090909
553962,EURUSD,20,-332.0,15,5,0.25
553962,GBPJPY,57,-1067.6799999999998,36,21,0.3684210526315789
553962,GBPUSD,33,-472.0,20,13,0.3939393939393939
553962,USDCAD,5,-7.430000000000007,4,1,0.2
553962,USDCHF,3,-174.91,3,0,0.0
553962,USDJPY,31,123.23000000000002,16,15,0.4838709677419355
554199,AUDUSD,21,-598.9700000000001,15,6,0.2857142857142857
554199,EURUSD,15,1013.6599999999999,9,6,0.4
554199,GBPJPY,22,-1682.5900000000001,16,6,0.2727272727272727
554199,GBPUSD,17,-912.3800000000001,11,6,0.35294117647058826
554199,NZDUSD,16,1003.13,10,6,0.375
554199,USDCAD,24,-3494.87,20,4,0.16666666666666666
554199,USDCHF,15,1032.11,7,8,0.5333333333333333
554199,USDJPY,21,-1720.5700000000002,16,5,0.23809523809523808
554208,AUDUSD,17,192.23,3,14,0.8235294117647058
554208,EURUSD,4841,-26332.85,1070,3771,0.7789712869241893
554208,GBPUSD,424,2095.35,88,336,0.7924528301886793
554208,USDCHF,12,11.059999999999999,2,10,0.8333333333333334
554208,USDJPY,164,4474.05,28,136,0.8292682926829268
554252,AUDUSD,1,-0.8,1,0,0.0
554252,EURGBP,2,-0.99,1,1,0.5
554252,EURJPY,1,0.52,0,1,1.0
554252,EURUSD,6,13.8,1,5,0.8333333333333334
554252,GBPUSD,199,-594.75,54,145,0.7286432160804021
554252,USDCAD,5,-4.2,3,2,0.4
554252,USDCHF,2,1.02,1,1,0.5
554252,USDJPY,10,-95.88000000000001,4,6,0.6
554255,AUDJPY,1,71.07,0,1,1.0
554255,AUDUSD,19,159.7,10,9,0.47368421052631576
554255,EURAUD,1,-45.59,1,0,0.0
554255,EURGBP,3,-90.56,2,1,0.3333333333333333
554255,EURJPY,4,-226.62,2,2,0.5
554255,EURUSD,61,-1683.29,44,17,0.2786885245901639
554255,GBPJPY,31,-1107.7900000000002,19,12,0.3870967741935484
554255,GBPUSD,10,194.49,4,6,0.6
554255,NZDUSD,2,-99.0,2,0,0.0
554255,USDCAD,14,902.12,5,9,0.6428571428571429
554255,USDCHF,9,-1450.3,8,1,0.1111111111111111
554255,USDJPY,28,-1417.73,13,15,0.5357142857142857
554371,AUDUSD,43,451.5,11,32,0.7441860465116279
554371,EURCHF,4,-51.730000000000004,3,1,0.25
554371,EURGBP,27,-1803.9500000000003,11,16,0.5925925925925926
554371,EURJPY,702,-18916.12,324,378,0.5384615384615384
554371,EURUSD,56,739.0999999999999,19,37,0.6607142857142857
554371,GBPJPY,44,40.999999999999986,12,32,0.7272727272727273
554371,GBPUSD,76,-1856.5,33,43,0.5657894736842105
554371,USDCAD,52,536.5899999999999,19,33,0.6346153846153846
554371,USDCHF,22,111.35999999999999,9,13,0.5909090909090909
554371,USDJPY,27,185.56,12,15,0.5555555555555556
554463,AUDUSD,3,-4.4,2,1,0.3333333333333333
554463,EURCHF,3,-0.16000000000000003,1,2,0.6666666666666666
554463,EURJPY,2,1.77,0,2,1.0
554463,EURUSD,90,-273.73,43,47,0.5222222222222223
554463,USDCHF,8,-4.74,4,4,0.5
554521,AUDUSD,4,-3.0,3,1,0.25
554521,EURJPY,3,3.1399999999999997,1,2,0.6666666666666666
554521,EURUSD,945,-1884.7,394,551,0.5830687830687831
554521,GBPUSD,8,1.0999999999999999,3,5,0.625
554521,USDCAD,2,-8.6,2,0,0.0
554521,USDCHF,6,-16.509999999999998,4,2,0.3333333333333333
554521,USDJPY,17,-60.88,13,4,0.23529411764705882
554578,AUDJPY,46,-361.69,31,15,0.32608695652173914
554578,AUDUSD,184,-749.54,118,66,0.358695652173913
554578,CADJPY,4,-29.180000000000003,3,1,0.25
554578,EURAUD,169,-421.55,93,76,0.44970414201183434
554578,EURCAD,6,-5.699999999999992,3,3,0.5
554578,EURCHF,7,21.459999999999994,5,2,0.2857142857142857
554578,EURGBP,20,-111.41000000000001,14,6,0.3
554578,EURJPY,514,-2380.83,297,217,0.42217898832684825
554578,EURUSD,1375,-2580.2599999999998,818,557,0.4050909090909091
554578,GBPCHF,7,86.02999999999999,3,4,0.5714285714285714
554578,GBPJPY,352,-1621.46,209,143,0.40625
554578,GBPUSD,1578,-5440.41,974,604,0.38276299112801015
554578,NZDUSD,13,-42.36,6,7,0.5384615384615384
554578,USDCAD,76,-635.87,51,25,0.32894736842105265
554578,USDCHF,69,-85.3,41,28,0.4057971014492754
554578,USDJPY,101,-353.71,56,45,0.44554455445544555
554578,XAGUSD,2,-19.919999999999998,1,1,0.5
554578,XAUUSD,4,-16.409999999999997,2,2,0.5
554616,AUDNZD,2,3.33,0,2,1.0
554616,AUDUSD,126,-800.7,36,90,0.7142857142857143
554616,EURAUD,13,-318.47,2,11,0.8461538461538461
554616,EURUSD,477,-1063.0,137,340,0.7127882599580713
554616,GBPUSD,37,55.9,12,25,0.6756756756756757
554616,NZDUSD,12,-251.4,4,8,0.6666666666666666
554616,USDCAD,26,93.72,4,22,0.8461538461538461
554616,USDCHF,12,19.21,2,10,0.8333333333333334
554616,USDJPY,2,1.08,0,2,1.0
554616,XAUUSD,24,-145.55,7,17,0.7083333333333334
554689,AUDJPY,10,31.669999999999987,2,8,0.8
554689,EURCHF,6,-93.99,1,5,0.8333333333333334
554689,EURGBP,4,65.66,1,3,0.75
554689,EURJPY,10,198.18,0,10,1.0
554689,EURUSD,48,515.46,8,40,0.8333333333333334
554689,GBPJPY,17,-107.69000000000003,2,15,0.8823529411764706
554689,GBPUSD,1,-6.9,1,0,0.0
554689,USDCHF,67,-2584.58,26,41,0.6119402985074627
554689,USDJPY,18,143.10999999999999,4,14,0.7777777777777778
554779,AUDJPY,1,-13.83,1,0,0.0
554779,EURAUD,1,0.0,1,0,0.0
554779,EURGBP,1,41.9,0,1,1.0
554779,EURJPY,2,-68.3,2,0,0.0
554779,EURUSD,66,-102.65,30,36,0.5454545454545454
554779,GBPCHF,1,2.03,0,1,1.0
554779,GBPJPY,1,-9.01,1,0,0.0
554779,GBPUSD,38,-538.9,23,15,0.39473684210526316
554779,NZDUSD,1,5.0,0,1,1.0
554779,USDJPY,1,8.4,0,1,1.0
554852,AUDCAD,68,444.23,28,40,0.5882352941176471
554852,AUDJPY,19,1338.76,3,16,0.8421052631578947
554852,AUDNZD,63,851.4,15,48,0.7619047619047619
554852,AUDUSD,68,-678.6600000000001,31,37,0.5441176470588235
554852,CADJPY,12,-87.29999999999997,3,9,0.75
554852,CHFJPY,34,1312.82,1,33,0.9705882352941176
554852,EURAUD,22,426.21,10,12,0.5454545454545454
554852,EURCAD,17,387.01,2,15,0.8823529411764706
554852,EURCHF,2,-7.2,2,0,0.0
554852,EURGBP,54,-1269.27,28,26,0.48148148148148145
554852,EURJPY,58,2172.33,17,41,0.7068965517241379
554852,EURUSD,353,-4094.96,110,243,0.6883852691218131
554852,GBPCHF,29,1200.3,11,18,0.6206896551724138
554852,GBPJPY,58,-1910.61,18,40,0.6896551724137931
554852,GBPUSD,124,-2463.74,49,75,0.6048387096774194
554852,NZDUSD,42,1315.81,6,36,0.8571428571428571
554852,USDCAD,41,311.32,10,31,0.7560975609756098
554852,USDCHF,75,1442.36,21,54,0.72
554852,USDJPY,225,-5967.2,53,172,0.7644444444444445
554852,XAUUSD,56,-201.92,26,30,0.5357142857142857
554882,AUDCAD,1,-1.99,1,0,0.0
554882,AUDUSD,12,-6.4,4,8,0.6666666666666666
554882,CHFJPY,1,1.8,0,1,1.0
554882,EURAUD,2,1.24,0,2,1.0
554882,EURCHF,2,1.1500000000000001,0,2,1.0
554882,EURGBP,2,-3.6100000000000003,2,0,0.0
554882,EURJPY,33,-11.499999999999998,15,18,0.5454545454545454
554882,EURUSD,142,-167.67,37,105,0.7394366197183099
554882,GBPJPY,16,-320.04,8,8,0.5
554882,GBPUSD,147,-707.91,55,92,0.6258503401360545
554882,NZDUSD,2,-2.49,2,0,0.0
554882,USDCAD,3,1.96,1,2,0.6666666666666666
554882,USDCHF,4,3.26,0,4,1.0
554882,USDJPY,2,0.52,0,2,1.0
554882,USDMXN,1,-10.47,1,0,0.0
554916,AUDUSD,15,-74.35000000000001,10,5,0.3333333333333333
554916,EURCHF,5,-335.25,4,1,0.2
554916,EURJPY,21,102.53,5,16,0.7619047619047619
554916,EURUSD,459,-4757.48,173,286,0.6230936819172114
554916,GBPUSD,1,-6.9,1,0,0.0
554916,USDCAD,22,-45.23000000000001,11,11,0.5
554916,USDCHF,48,-855.96,33,15,0.3125
554916,USDJPY,24,-76.13,14,10,0.4166666666666667
554916,XAUUSD,2,7.240000000000001,1,1,0.5
555308,AUDCAD,1,-34.3,1,0,0.0
555308,EURJPY,4,110.52,0,4,1.0
555308,EURUSD,1,-0.51,1,0,0.0
555308,GBPCHF,1,8.18,0,1,1.0
555308,GBPJPY,125,6468.049999999999,2,123,0.984
555308,GBPUSD,3,13.099999999999994,1,2,0.6666666666666666
555308,XAUUSD,1,14.0,0,1,1.0
555402,EURGBP,2,-19.57,2,0,0.0
555402,EURUSD,132,11.5,50,82,0.6212121212121212
555402,GBPUSD,32,-524.0,19,13,0.40625
555402,USDJPY,2,-6.45,2,0,0.0
555539,AUDNZD,2,0.2,1,1,0.5
555539,AUDUSD,11,-351.0,4,7,0.6363636363636364
555539,EURUSD,351,-193.1,94,257,0.7321937321937322
555539,GBPUSD,268,-4185.9,77,191,0.7126865671641791
555539,USDJPY,10,23.37,3,7,0.7
555883,EURJPY,111,4885.07,20,91,0.8198198198198198
555883,EURUSD,71,-1530.0,17,54,0.7605633802816901
555883,GBPJPY,2,63.43000000000001,0,2,1.0
555883,GBPUSD,551,-7789.0,101,450,0.8166969147005445
555883,USDJPY,1,33.39,0,1,1.0
556274,EURUSD,115,-271.90000000000003,42,73,0.6347826086956522
556351,EURGBP,1,6.55,0,1,1.0
556351,EURUSD,39,-1440.0,23,16,0.41025641025641024
556351,GBPUSD,109,-3094.0,54,55,0.5045871559633027
556351,NZDUSD,1,-18.0,1,0,0.0
556351,USDCAD,5,-13.04,2,3,0.6
556351,USDCHF,7,28.93,2,5,0.7142857142857143
556351,USDJPY,4,-29.939999999999998,3,1,0.25
556353,AUDUSD,38,-275.7,15,23,0.6052631578947368
556353,EURAUD,1,-3.24,1,0,0.0
556353,EURUSD,52,-236.4,23,29,0.5576923076923077
556353,GBPUSD,99,-237.72,26,73,0.7373737373737373
556353,NZDUSD,2,-13.2,2,0,0.0
556353,USDCAD,1,-16.45,1,0,0.0
556353,USDCHF,5,-2.7199999999999998,4,1,0.2
556353,USDJPY,34,25.84,8,26,0.7647058823529411
556353,XAGUSD,17,-80.47,10,7,0.4117647058823529
556353,XAUUSD,89,-355.69,36,53,0.5955056179775281
556359,AUDCAD,1,-0.75,1,0,0.0
556359,AUDJPY,1,-11.74,1,0,0.0
556359,AUDUSD,7,24.400000000000002,2,5,0.7142857142857143
556359,EURCAD,3,12.06,0,3,1.0
556359,EURCHF,1,2.98,0,1,1.0
556359,EURGBP,1,-2.12,1,0,0.0
556359,EURUSD,69,-1239.78,37,32,0.463768115942029
556359,GBPUSD,18,-259.20000000000005,12,6,0.3333333333333333
556359,NZDUSD,5,-26.5,4,1,0.2
556359,USDCAD,6,-5.039999999999999,3,3,0.5
556359,USDCHF,6,-41.84,4,2,0.3333333333333333
556359,USDJPY,14,-86.55,10,4,0.2857142857142857
556628,AUDJPY,9,-9.27,5,4,0.4444444444444444
556628,AUDUSD,16,1.299999999999999,7,9,0.5625
556628,CHFJPY,1,1.95,0,1,1.0
556628,EURGBP,1,-11.18,1,0,0.0
556628,EURJPY,57,10.690000000000001,32,25,0.43859649122807015
556628,EURUSD,34,-79.62,18,16,0.47058823529411764
556628,GBPJPY,46,-49.43,23,23,0.5
556628,GBPUSD,57,-70.6,29,28,0.49122807017543857
556628,NZDUSD,1,-0.5,1,0,0.0
556628,USDCAD,4,7.010000000000001,0,4,1.0
556628,USDCHF,6,21.150000000000002,2,4,0.6666666666666666
556628,USDJPY,25,40.47,10,15,0.6
556628,XAGUSD,1,-1.0,1,0,0.0
556705,AUDUSD,89,98.72999999999999,27,62,0.6966292134831461
556705,EURCHF,4,-7.669999999999999,2,2,0.5
556705,EURUSD,1526,-449.57,725,801,0.5249017038007864
556705,GBPUSD,12,2.3000000000000003,4,8,0.6666666666666666
556705,NZDUSD,2,-2.86,2,0,0.0
556705,USDCAD,29,10.21,10,19,0.6551724137931034
556705,USDCHF,9,8.85,3,6,0.6666666666666666
556705,USDJPY,42,22.58,13,29,0.6904761904761905
556705,XAUUSD,5,-3.42,1,4,0.8
556717,EURUSD,54,-1972.4,28,26,0.48148148148148145
556717,USDJPY,282,-34675.17,123,159,0.5638297872340425
556721,EURUSD,406,-1776.87,95,311,0.7660098522167488
556721,GBPUSD,12,-199.0,3,9,0.75
556721,USDCHF,2,1.5,0,2,1.0
556721,USDJPY,10,-123.88000000000001,3,7,0.7
556813,EURJPY,18,-42.959999999999994,13,5,0.2777777777777778
556813,EURUSD,473,-1201.43,171,302,0.638477801268499
556813,GBPUSD,30,-242.87,19,11,0.36666666666666664
556813,USDCHF,5,37.44,2,3,0.6
556813,USDJPY,89,-7.31,34,55,0.6179775280898876
557096,AUDCAD,3,202.77000000000004,2,1,0.3333333333333333
557096,AUDNZD,2,1459.45,0,2,1.0
557096,AUDUSD,3,1150.0,0,3,1.0
557096,CHFJPY,2,-6289.07,2,0,0.0
557096,EURCHF,1,-146.57,1,0,0.0
557096,EURGBP,5,1447.6100000000001,1,4,0.8
557096,EURJPY,2,1009.53,1,1,0.5
557096,EURUSD,75,11199.0,18,57,0.76
557096,GBPUSD,11,-570.0,3,8,0.7272727272727273
557096,NZDUSD,2,-3450.0,2,0,0.0
557096,USDCAD,6,743.1199999999999,2,4,0.6666666666666666
557096,USDCHF,17,-5987.02,7,10,0.5882352941176471
557096,USDJPY,4,586.07,1,3,0.75
557096,XAUUSD,11,-13837.35,2,9,0.8181818181818182
557196,AUDCAD,8,1319.7299999999998,2,6,0.75
557196,AUDJPY,3,1117.21,0,3,1.0
557196,AUDUSD,18,44.0,7,11,0.6111111111111112
557196,EURCHF,7,538.38,1,6,0.8571428571428571
557196,EURGBP,6,-2642.56,3,3,0.5
557196,EURJPY,36,1918.04,8,28,0.7777777777777778
557196,EURUSD,44,-8334.0,10,34,0.7727272727272727
557196,GBPJPY,15,540.3299999999998,4,11,0.7333333333333333
557196,GBPUSD,31,3483.0,3,28,0.9032258064516129
557196,NZDUSD,2,-411.0,2,0,0.0
557196,USDCAD,94,5127.049999999999,13,81,0.8617021276595744
557196,USDCHF,7,-1424.1899999999998,1,6,0.8571428571428571
557196,USDJPY,76,5186.55,14,62,0.8157894736842105
557196,XAGUSD,5,-4900.0,2,3,0.6
557196,XAUUSD,33,10580.5,5,28,0.8484848484848485
557256,AUDJPY,3,-2.1300000000000003,2,1,0.3333333333333333
557256,AUDNZD,1,-3.55,1,0,0.0
557256,AUDUSD,31,-275.5,21,10,0.3225806451612903
557256,CHFJPY,12,117.97999999999999,6,6,0.5
557256,EURAUD,1,0.0,1,0,0.0
557256,EURCAD,2,-0.6300000000000008,1,1,0.5
557256,EURCHF,2,-63.42,2,0,0.0
557256,EURGBP,2,-25.810000000000002,2,0,0.0
557256,EURJPY,49,-147.71,36,13,0.2653061224489796
557256,EURUSD,103,325.37,64,39,0.3786407766990291
557256,GBPJPY,1,-0.98,1,0,0.0
557256,GBPUSD,76,-625.65,57,19,0.25
557256,NZDUSD,9,-34.6,6,3,0.3333333333333333
557256,USDCAD,20,-179.76000000000002,14,6,0.3
557256,USDCHF,14,-37.24,9,5,0.35714285714285715
557256,USDJPY,10,-17.99,9,1,0.1
557276,AUDUSD,16,28.1,2,14,0.875
557276,EURJPY,12,-44.39000000000001,5,7,0.5833333333333334
557276,EURUSD,34,-102.9,16,18,0.5294117647058824
557276,GBPCHF,9,36.0,0,9,1.0
557276,GBPUSD,10,19.7,2,8,0.8
557276,USDCHF,14,-45.870000000000005,4,10,0.7142857142857143
557276,USDJPY,8,24.090000000000003,1,7,0.875
557407,GBPUSD,179,-2563.5,45,134,0.7486033519553073
557760,AUDNZD,1,-2.27,1,0,0.0
557760,AUDUSD,2,2.3,0,2,1.0
557760,EURCAD,1,-7.36,1,0,0.0
557760,EURCHF,6,5.5600000000000005,1,5,0.8333333333333334
557760,EURGBP,3,-9.03,1,2,0.6666666666666666
557760,EURJPY,12,11.03,4,8,0.6666666666666666
557760,EURUSD,75,7.6,20,55,0.7333333333333333
557760,GBPUSD,21,-2.4000000000000004,7,14,0.6666666666666666
557760,USDCAD,1,1.61,0,1,1.0
557760,USDCHF,61,-179.35,21,40,0.6557377049180327
557760,USDJPY,37,38.66,11,26,0.7027027027027027
557766,AUDUSD,32,-604.77,11,21,0.65625
557766,EURCHF,2,-212.44,2,0,0.0
557766,EURGBP,12,103.10999999999999,5,7,0.5833333333333334
557766,EURJPY,11,452.93,1,10,0.9090909090909091
557766,EURUSD,174,-811.68,40,134,0.7701149425287356
557766,GBPJPY,3,146.46,1,2,0.6666666666666666
557766,GBPUSD,39,-1875.21,20,19,0.48717948717948717
557766,NZDUSD,1,54.0,0,1,1.0
557766,USDCAD,53,-41.35000000000003,21,32,0.6037735849056604
557766,USDCHF,13,224.28,2,11,0.8461538461538461
557766,USDJPY,21,166.60999999999999,6,15,0.7142857142857143
557888,EURUSD,6,-124.3,5,1,0.16666666666666666
557888,USDJPY,325,-3104.11,133,192,0.5907692307692308
558066,AUDJPY,6,635.1800000000001,1,5,0.8333333333333334
558066,AUDUSD,26,-1672.49,19,7,0.2692307692307692
558066,CADJPY,8,-1110.21,8,0,0.0
558066,CHFJPY,4,73.57999999999998,1,3,0.75
558066,EURAUD,5,318.90999999999997,1,4,0.8
558066,EURGBP,1,0.0,1,0,0.0
558066,EURJPY,23,194.3,11,12,0.5217391304347826
558066,EURUSD,32,220.11,19,13,0.40625
558066,GBPCHF,3,109.66999999999999,1,2,0.6666666666666666
558066,GBPJPY,6,-11.149999999999977,3,3,0.5
558066,GBPUSD,30,-0.09999999999999432,13,17,0.5666666666666667
558066,NZDUSD,11,-421.23,8,3,0.2727272727272727
558066,USDCAD,22,-724.53,17,5,0.22727272727272727
558066,USDCHF,5,67.73999999999998,3,2,0.4
558066,USDJPY,7,239.71,2,5,0.7142857142857143
558139,EURGBP,2,-2.5,2,0,0.0
558139,EURJPY,5,9.329999999999998,1,4,0.8
558139,EURUSD,4262,-5275.610000000001,716,3546,0.8320037541060535
558139,GBPUSD,1,3.0,0,1,1.0
558139,USDJPY,165,-1715.24,44,121,0.7333333333333333
558139,USDTRY,279,-1528.95,66,213,0.7634408602150538
558139,XAGUSD,1,1.0,0,1,1.0
558139,XAUUSD,1476,-6088.0,253,1223,0.8285907859078591
558398,EURGBP,1,-142.34,1,0,0.0
558398,EURJPY,157,-1711.9599999999998,114,43,0.27388535031847133
558398,GBPJPY,5,-690.36,5,0,0.0
558398,GBPUSD,1,-132.0,1,0,0.0
558403,EURUSD,160,-506.4,57,103,0.64375
558528,EURUSD,158,-584.87,78,80,0.5063291139240507
558528,GBPJPY,3,-159.07999999999998,3,0,0.0
558528,GBPUSD,34,-153.0,17,17,0.5
558528,USDJPY,90,-793.95,56,34,0.37777777777777777
558594,AUDCAD,8,1434.67,2,6,0.75
558594,AUDJPY,6,-644.8499999999995,1,5,0.8333333333333334
558594,AUDNZD,5,-1732.9199999999998,2,3,0.6
558594,AUDUSD,30,-2647.5,10,20,0.6666666666666666
558594,CADJPY,4,438.92,1,3,0.75
558594,EURAUD,5,1315.43,0,5,1.0
558594,EURCAD,10,1899.09,0,10,1.0
558594,EURGBP,6,-568.16,3,3,0.5
558594,EURJPY,4,334.38000000000005,2,2,0.5
558594,EURUSD,27,-1030.0,11,16,0.5925925925925926
558594,GBPJPY,2,-604.83,1,1,0.5
558594,GBPUSD,18,620.0,7,11,0.6111111111111112
558594,NZDUSD,9,-2290.0,6,3,0.3333333333333333
558594,USDCAD,35,-7851.640000000001,13,22,0.6285714285714286
558594,USDCHF,8,624.42,2,6,0.75
558594,USDJPY,9,-388.19,4,5,0.5555555555555556
558594,USDMXN,5,1350.5,1,4,0.8
558594,USDTRY,12,-611.3199999999999,2,10,0.8333333333333334
558594,XAGUSD,27,-2771.2,12,15,0.5555555555555556
558594,XAUUSD,101,-17849.25,33,68,0.6732673267326733
558615,AUDJPY,2,66.22999999999999,0,2,1.0
558615,AUDUSD,29,1063.53,4,25,0.8620689655172413
558615,EURGBP,3,-415.93,1,2,0.6666666666666666
558615,EURJPY,19,40.660000000000004,5,14,0.7368421052631579
558615,EURUSD,145,-11099.83,23,122,0.8413793103448276
558615,GBPCHF,2,31.14,1,1,0.5
558615,GBPJPY,20,-2904.0,8,12,0.6
558615,GBPUSD,144,2241.58,16,128,0.8888888888888888
558615,NZDUSD,11,586.95,1,10,0.9090909090909091
558615,USDCAD,3,71.28,0,3,1.0
558615,USDCHF,23,-2663.85,8,15,0.6521739130434783
558615,USDJPY,32,2054.07,2,30,0.9375
558809,AUDUSD,6,-73.4,3,3,0.5
558809,EURCHF,2,-25.16,1,1,0.5
558809,EURGBP,1,0.0,1,0,0.0
558809,EURJPY,16,-24.500000000000004,5,11,0.6875
558809,EURUSD,65,-90.0,23,42,0.6461538461538462
558809,GBPUSD,19,-253.2,9,10,0.5263157894736842
558809,USDCAD,1,5.76,0,1,1.0
558809,USDCHF,7,-79.8,4,3,0.42857142857142855
558809,USDJPY,16,-97.22,7,9,0.5625
558986,AUDCAD,1,-0.95,1,0,0.0
558986,AUDJPY,201,-2920.29,22,179,0.8905472636815921
558986,AUDNZD,4,80.84,1,3,0.75
558986,AUDUSD,188,11439.4,22,166,0.8829787234042553
558986,CADJPY,10,289.51,2,8,0.8
558986,CHFJPY,4,276.87,0,4,1.0
558986,EURAUD,5,341.87,1,4,0.8
558986,EURCAD,2,106.84,0,2,1.0
558986,EURCHF,8,-955.94,2,6,0.75
558986,EURGBP,44,1487.57,6,38,0.8636363636363636
558986,EURJPY,73,2901.1,7,66,0.9041095890410958
558986,EURUSD,128,5821.5,15,113,0.8828125
558986,GBPCHF,1,206.65,0,1,1.0
558986,GBPJPY,58,3500.18,2,56,0.9655172413793104
558986,GBPUSD,172,5393.0,22,150,0.872093023255814
558986,NZDUSD,41,2964.3,4,37,0.9024390243902439
558986,USDCAD,91,6288.71,4,87,0.9560439560439561
558986,USDCHF,15,700.76,3,12,0.8
558986,USDJPY,125,8124.17,7,118,0.944
558986,USDTRY,75,-59256.799999999996,11,64,0.8533333333333334
559085,AUDJPY,5,-457.91,4,1,0.2
559085,AUDUSD,31,-635.89,8,23,0.7419354838709677
559085,EURJPY,7,-213.43999999999997,5,2,0.2857142857142857
559085,EURUSD,322,102.86000000000007,38,284,0.8819875776397516
559085,GBPJPY,3,-989.1899999999999,3,0,0.0
559085,GBPUSD,43,-1850.6,19,24,0.5581395348837209
559085,NZDUSD,14,-1065.6,6,8,0.5714285714285714
559085,USDCHF,2,136.14,0,2,1.0
559085,USDJPY,17,21.700000000000053,6,11,0.6470588235294118
559133,AUDCAD,2,-9.1,1,1,0.5
559133,AUDJPY,1,-13.29,1,0,0.0
559133,AUDNZD,29,-8.05,16,13,0.4482758620689655
559133,AUDUSD,128,-154.10000000000002,55,73,0.5703125
559133,EURAUD,57,-156.54,31,26,0.45614035087719296
559133,EURCAD,13,-21.73,8,5,0.38461538461538464
559133,EURGBP,61,20.509999999999998,31,30,0.4918032786885246
559133,EURJPY,11,1.0500000000000007,8,3,0.2727272727272727
559133,EURUSD,1197,-3224.6899999999996,466,731,0.6106934001670844
559133,GBPCHF,7,12.479999999999999,3,4,0.5714285714285714
559133,GBPJPY,8,9.89,4,4,0.5
559133,GBPUSD,203,60.21,90,113,0.5566502463054187
559133,NZDUSD,102,-112.60999999999999,46,56,0.5490196078431373
559133,USDCAD,123,-146.42000000000002,58,65,0.5284552845528455
559133,USDCHF,10,-14.28,6,4,0.4
559133,USDJPY,45,7.290000000000001,22,23,0.5111111111111111
559133,XAGUSD,20,-0.5,8,12,0.6
559133,XAUUSD,104,131.04,50,54,0.5192307692307693
559137,EURUSD,22,2496.58,9,13,0.5909090909090909
559137,USDCAD,45,983.7,22,23,0.5111111111111111
559137,XAGUSD,109,551.8,51,58,0.5321100917431193
559137,XAUUSD,605,-20242.58,280,325,0.5371900826446281
559147,AUDUSD,408,-2744.88,82,326,0.7990196078431373
559147,CADJPY,2,19.68,0,2,1.0
559147,EURJPY,22,-367.88,8,14,0.6363636363636364
559147,EURUSD,660,-2039.6499999999999,106,554,0.8393939393939394
559147,GBPUSD,20,286.0,0,20,1.0
559147,NZDUSD,2,0.0,1,1,0.5
559147,USDCHF,17,-96.56,3,14,0.8235294117647058
559147,USDJPY,109,-447.62,20,89,0.8165137614678899
559147,USDTRY,1,-10.37,1,0,0.0
559545,AUDUSD,143,-335.05,96,47,0.32867132867132864
559545,EURCHF,1,-9.67,1,0,0.0
559545,EURGBP,2,-31.869999999999997,2,0,0.0
559545,EURJPY,884,-1986.01,556,328,0.37104072398190047
559545,EURUSD,315,69.10000000000001,196,119,0.37777777777777777
559545,GBPUSD,234,-414.94,159,75,0.32051282051282054
559545,USDCAD,6,31.370000000000005,4,2,0.3333333333333333
559545,USDCHF,50,-201.82,33,17,0.34
559545,USDJPY,8,-141.09,7,1,0.125
559650,AUDCAD,1,0.0,1,0,0.0
559650,AUDJPY,4,-611.8600000000001,3,1,0.25
559650,AUDNZD,65,-614.46,59,6,0.09230769230769231
559650,AUDUSD,45,-385.0,15,30,0.6666666666666666
559650,CHFJPY,2,-1.63,2,0,0.0
559650,EURAUD,2,-1.58,1,1,0.5
559650,EURCHF,62,-117.13,49,13,0.20967741935483872
559650,EURGBP,77,-1362.3700000000001,57,20,0.2597402597402597
559650,EURJPY,3,-71.57,2,1,0.3333333333333333
559650,EURUSD,170,-3598.0,96,74,0.43529411764705883
559650,GBPCHF,7,-613.05,5,2,0.2857142857142857
559650,GBPJPY,5,1041.49,2,3,0.6
559650,GBPUSD,144,-4177.4,74,70,0.4861111111111111
559650,NZDUSD,1,66.0,0,1,1.0
559650,USDCAD,89,-438.89,55,34,0.38202247191011235
559650,USDCHF,8,-4.169999999999989,4,4,0.5
559650,USDJPY,13,-475.32,10,3,0.23076923076923078
559672,AUDJPY,6,58.66,1,5,0.8333333333333334
559672,AUDNZD,4,27.54,1,3,0.75
559672,AUDUSD,3,4.1000000000000005,0,3,1.0
559672,CADJPY,5,-14.590000000000018,2,3,0.6
559672,CHFJPY,3,16.42,1,2,0.6666666666666666
559672,EURAUD,7,-5.699999999999996,3,4,0.5714285714285714
559672,EURCAD,1,-0.56,1,0,0.0
559672,EURGBP,10,118.03999999999999,2,8,0.8
559672,EURJPY,17,69.42,1,16,0.9411764705882353
559672,EURUSD,42,-135.4,4,38,0.9047619047619048
559672,GBPCHF,11,-99.13,5,6,0.5454545454545454
559672,GBPJPY,17,141.91,2,15,0.8823529411764706
559672,GBPUSD,72,-107.8,17,55,0.7638888888888888
559672,USDCAD,13,62.8,2,11,0.8461538461538461
559672,USDCHF,8,-12.14,3,5,0.625
559672,USDJPY,6,17.28,2,4,0.6666666666666666
559672,USDMXN,3,27.21,1,2,0.6666666666666666
559672,XAUUSD,2,20.3,0,2,1.0
560171,AUDUSD,2,117.0,0,2,1.0
560171,CADJPY,28,-1014.38,13,15,0.5357142857142857
560171,EURJPY,13,-251.21,6,7,0.5384615384615384
560171,EURUSD,116,717.5,39,77,0.6637931034482759
560171,GBPJPY,2,-70.04999999999998,1,1,0.5
560171,GBPUSD,162,86.0,56,106,0.654320987654321
560171,USDCAD,8,-286.52,4,4,0.5
560171,USDCHF,56,564.97,17,39,0.6964285714285714
560171,USDJPY,32,422.9,11,21,0.65625
560171,XAUUSD,2,-936.0,1,1,0.5
560237,AUDJPY,3,-4.220000000000001,2,1,0.3333333333333333
560237,AUDUSD,125,357.74,64,61,0.488
560237,EURGBP,42,-5.409999999999998,19,23,0.5476190476190477
560237,EURJPY,240,-1227.9,130,110,0.4583333333333333
560237,EURUSD,705,-1668.8600000000001,366,339,0.4808510638297872
560237,GBPCHF,1,-60.41,1,0,0.0
560237,GBPJPY,3,-4.5699999999999985,2,1,0.3333333333333333
560237,GBPUSD,271,-949.88,140,131,0.4833948339483395
560237,NZDUSD,9,-204.0,7,2,0.2222222222222222
560237,USDCAD,1,-11.56,1,0,0.0
560237,USDCHF,44,84.82,20,24,0.5454545454545454
560237,USDJPY,127,-726.51,83,44,0.3464566929133858
560237,USDMXN,1,3.8,0,1,1.0
560237,XAUUSD,6,-32.4,5,1,0.16666666666666666
560246,AUDUSD,1,-148.0,1,0,0.0
560246,EURGBP,1,71.68,0,1,1.0
560246,EURJPY,2,238.97,0,2,1.0
560246,EURUSD,73,316.12,35,38,0.5205479452054794
560246,GBPJPY,20,-229.62,11,9,0.45
560246,GBPUSD,24,-143.9,13,11,0.4583333333333333
560246,NZDUSD,6,194.0,2,4,0.6666666666666666
560246,USDCAD,5,-27.33,3,2,0.4
560246,USDCHF,4,-46.78,3,1,0.25
560246,USDJPY,11,-202.19,6,5,0.45454545454545453
560459,AUDCAD,11,625.08,2,9,0.8181818181818182
560459,AUDJPY,2,219.65,0,2,1.0
560459,AUDNZD,5,485.39000000000004,1,4,0.8
560459,AUDUSD,63,-71608.3,7,56,0.8888888888888888
560459,CADJPY,2,49.660000000000004,1,1,0.5
560459,CHFJPY,2,-175.51000000000005,1,1,0.5
560459,EURAUD,66,-27884.980000000003,7,59,0.8939393939393939
560459,EURCAD,43,-15753.84,5,38,0.8837209302325582
560459,EURCHF,7,120.57,2,5,0.7142857142857143
560459,EURGBP,6,147.57000000000002,2,4,0.6666666666666666
560459,EURJPY,36,1050.0999999999997,11,25,0.6944444444444444
560459,EURUSD,272,-8503.0,54,218,0.8014705882352942
560459,GBPJPY,29,9147.76,5,24,0.8275862068965517
560459,GBPUSD,622,8002.84,116,506,0.8135048231511254
560459,NZDUSD,2,80.0,1,1,0.5
560459,USDCAD,26,-954.2599999999998,11,15,0.5769230769230769
560459,USDCHF,43,-2887.0199999999995,11,32,0.7441860465116279
560459,USDJPY,60,-273.7299999999995,17,43,0.7166666666666667
560530,EURUSD,434,-723.3,142,292,0.6728110599078341
560530,GBPUSD,87,76.0,16,71,0.8160919540229885
560530,USDCHF,20,-31.689999999999998,9,11,0.55
560530,USDJPY,33,67.18,5,28,0.8484848484848485
560578,AUDJPY,2,-32.43,1,1,0.5
560578,AUDUSD,2,-77.0,2,0,0.0
560578,CADJPY,1,-28.1,1,0,0.0
560578,CHFJPY,2,-68.65,2,0,0.0
560578,EURCAD,1,-131.79,1,0,0.0
560578,EURGBP,11,26.110000000000003,5,6,0.5454545454545454
560578,EURJPY,5,-216.79,3,2,0.4
560578,EURUSD,126,-721.1,54,72,0.5714285714285714
560578,GBPCHF,3,28.450000000000003,1,2,0.6666666666666666
560578,GBPJPY,8,-168.54000000000002,4,4,0.5
560578,GBPUSD,71,-1407.96,40,31,0.43661971830985913
560578,NZDUSD,3,-67.0,3,0,0.0
560578,USDCAD,8,52.85,4,4,0.5
560578,USDCHF,9,-305.69,8,1,0.1111111111111111
560578,USDJPY,3,28.05,1,2,0.6666666666666666
560684,AUDJPY,1,-10.38,1,0,0.0
560684,AUDUSD,1,5.0,0,1,1.0
560684,CADJPY,4,-80.8,4,0,0.0
560684,CHFJPY,4,-79.7,4,0,0.0
560684,EURJPY,28,34.78,14,14,0.5
560684,EURUSD,30,-206.63,26,4,0.13333333333333333
560684,GBPJPY,11,-70.55,5,6,0.5454545454545454
560684,GBPUSD,10,-133.1,6,4,0.4
560684,USDCHF,1,-15.66,1,0,0.0
560684,USDJPY,9,64.35,3,6,0.6666666666666666
560684,USDTRY,1,-33.22,1,0,0.0
560684,XAGUSD,13,267.9,2,11,0.8461538461538461
560716,AUDUSD,108,-1566.0,46,62,0.5740740740740741
560738,AUDCAD,4,-33.04,4,0,0.0
560738,AUDJPY,7,-57.94,5,2,0.2857142857142857
560738,AUDNZD,4,5.18,2,2,0.5
560738,AUDUSD,20,-59.70000000000001,12,8,0.4
560738,CADJPY,16,71.49,8,8,0.5
560738,CHFJPY,16,-43.46,12,4,0.25
560738,EURAUD,7,-0.28999999999999826,5,2,0.2857142857142857
560738,EURCAD,12,-38.660000000000004,8,4,0.3333333333333333
560738,EURCHF,3,-2.36,2,1,0.3333333333333333
560738,EURGBP,9,9.230000000000002,5,4,0.4444444444444444
560738,EURJPY,12,21.92,10,2,0.16666666666666666
560738,EURUSD,23,-106.8,21,2,0.08695652173913043
560738,GBPCHF,25,-65.81,17,8,0.32
560738,GBPJPY,19,10.450000000000001,12,7,0.3684210526315789
560738,GBPUSD,31,-43.19,20,11,0.3548387096774194
560738,NZDUSD,4,-14.200000000000001,3,1,0.25
560738,USDCAD,12,-18.98,8,4,0.3333333333333333
560738,USDCHF,20,-30.59,13,7,0.35
560738,USDJPY,20,-24.109999999999996,11,9,0.45
560741,AUDJPY,9,424.30000000000007,2,7,0.7777777777777778
560741,AUDUSD,17,-921.0,5,12,0.7058823529411765
560741,CHFJPY,1,91.57,0,1,1.0
560741,EURGBP,12,572.48,0,12,1.0
560741,EURJPY,50,1058.34,12,38,0.76
560741,EURUSD,47,988.0,11,36,0.7659574468085106
560741,GBPCHF,1,46.66,0,1,1.0
560741,GBPJPY,6,1087.7,0,6,1.0
560741,GBPUSD,27,274.1,6,21,0.7777777777777778
560741,USDCHF,19,-1094.87,11,8,0.42105263157894735
560741,USDJPY,10,-2393.84,7,3,0.3
560741,XAGUSD,3,-1050.0,1,2,0.6666666666666666
560743,EURUSD,251,-1653.4,97,154,0.6135458167330677
560743,GBPUSD,8,-28.9,4,4,0.5
560743,USDJPY,12,-279.98,9,3,0.25
560743,XAUUSD,2,-27.8,1,1,0.5
560988,EURAUD,1,0.18,0,1,1.0
560988,EURCAD,2,5.6,0,2,1.0
560988,EURJPY,3,-45.50999999999999,1,2,0.6666666666666666
560988,EURUSD,66,-1516.5,19,47,0.7121212121212122
560988,GBPJPY,6,129.14,2,4,0.6666666666666666
560988,GBPUSD,17,-537.85,5,12,0.7058823529411765
560988,USDCHF,1,-1.72,1,0,0.0
560988,USDJPY,5,156.42999999999998,1,4,0.8
561088,AUDCAD,4,-42.53,3,1,0.25
561088,AUDUSD,4,22.0,1,3,0.75
561088,EURAUD,4,-53.18,2,2,0.5
561088,EURCAD,5,-58.179999999999986,3,2,0.4
561088,EURCHF,4,-42.410000000000004,4,0,0.0
561088,EURGBP,3,-534.79,2,1,0.3333333333333333
561088,EURJPY,1,6.64,0,1,1.0
561088,EURUSD,166,-3595.4,53,113,0.6807228915662651
561088,GBPCHF,3,-459.68,2,1,0.3333333333333333
561088,GBPJPY,4,-190.32,3,1,0.25
561088,GBPUSD,31,-150.8,14,17,0.5483870967741935
561088,USDCAD,15,5.5199999999999925,4,11,0.7333333333333333
561088,USDCHF,1,-20.02,1,0,0.0
561088,USDJPY,2,21.94,1,1,0.5
561237,EURJPY,763,-19487.079999999998,381,382,0.5006553079947575
561436,EURUSD,247,-1507.53,55,192,0.7773279352226721
561570,AUDUSD,6,-110.0,6,0,0.0
561570,CHFJPY,1,-17.91,1,0,0.0
561570,EURJPY,2,5.670000000000002,1,1,0.5
561570,EURUSD,80,-382.0,47,33,0.4125
561570,GBPUSD,22,-317.0,16,6,0.2727272727272727
561570,XAUUSD,2,-94.5,2,0,0.0
561630,CHFJPY,3,8.82,0,3,1.0
561630,EURJPY,10,-813.5,6,4,0.4
561630,EURUSD,237,-5675.0,104,133,0.5611814345991561
561630,GBPJPY,2,-78.89,1,1,0.5
561630,GBPUSD,122,-8730.3,47,75,0.6147540983606558
561630,USDCAD,1,-26.92,1,0,0.0
561630,USDCHF,1,-1.12,1,0,0.0
561630,USDJPY,1,0.0,1,0,0.0
561728,AUDUSD,5,1.8,0,5,1.0
561728,CADJPY,1,-2.04,1,0,0.0
561728,CHFJPY,1,0.55,0,1,1.0
561728,EURGBP,5,2.51,1,4,0.8
561728,EURUSD,294,-227.1,33,261,0.8877551020408163
561728,GBPCHF,1,0.28,0,1,1.0
561728,GBPUSD,12,-45.3,4,8,0.6666666666666666
561728,NZDUSD,2,-2.2,1,1,0.5
561728,USDJPY,17,-19.68,7,10,0.5882352941176471
561769,AUDCAD,1,-4.46,1,0,0.0
561769,AUDJPY,1,0.0,1,0,0.0
561769,AUDUSD,1,4.4,0,1,1.0
561769,CHFJPY,3,14.5,0,3,1.0
561769,EURAUD,1,0.0,1,0,0.0
561769,EURCAD,2,71.6,0,2,1.0
561769,EURJPY,4,-446.18,3,1,0.25
561769,EURUSD,96,-888.26,26,70,0.7291666666666666
561769,GBPCHF,1,6.85,0,1,1.0
561769,GBPJPY,7,-67.1,4,3,0.42857142857142855
561769,GBPUSD,69,132.1,20,49,0.7101449275362319
561769,USDCAD,1,30.67,0,1,1.0
561769,USDCHF,5,-215.82,2,3,0.6
561769,USDJPY,2,2.41,1,1,0.5
561783,AUDUSD,10,-36.1,9,1,0.1
561783,EURUSD,307,-179.49,143,164,0.5342019543973942
561783,GBPJPY,12,-26.5,6,6,0.5
561783,GBPUSD,15,-10.7,7,8,0.5333333333333333
561783,USDCHF,9,-16.02,5,4,0.4444444444444444
561783,USDJPY,227,-22.969999999999995,97,130,0.5726872246696035
561783,XAUUSD,3,7.0,1,2,0.6666666666666666
561803,AUDUSD,24,-97.95,17,7,0.2916666666666667
561803,CADJPY,10,18.770000000000003,5,5,0.5
561803,EURUSD,23,-86.8,14,9,0.391304347826087
561803,GBPJPY,51,-445.67,33,18,0.35294117647058826
561803,GBPUSD,51,-198.4,30,21,0.4117647058823529
561803,USDCAD,9,-61.36,8,1,0.1111111111111111
561803,USDCHF,5,-22.22,4,1,0.2
561803,USDJPY,22,-34.97,16,6,0.2727272727272727
561910,AUDJPY,16,281.26,4,12,0.75
561910,AUDUSD,23,236.4,8,15,0.6521739130434783
561910,CADJPY,13,527.64,5,8,0.6153846153846154
561910,EURGBP,23,602.64,4,19,0.8260869565217391
561910,EURJPY,143,-8103.290000000001,45,98,0.6853146853146853
561910,EURUSD,68,-16264.1,23,45,0.6617647058823529
561910,GBPCHF,33,238.65999999999997,10,23,0.696969696969697
561910,GBPJPY,33,999.94,11,22,0.6666666666666666
561910,GBPUSD,23,-997.6999999999999,9,14,0.6086956521739131
561910,USDCHF,26,-1757.5,11,15,0.5769230769230769
561910,USDJPY,43,179.72999999999996,17,26,0.6046511627906976
561910,XAUUSD,9,420.05,1,8,0.8888888888888888
561926,AUDUSD,6,27.200000000000003,0,6,1.0
561926,EURGBP,2,-49.31,2,0,0.0
561926,EURJPY,63,944.82,28,35,0.5555555555555556
561926,EURUSD,90,-1698.7099999999998,29,61,0.6777777777777778
561926,GBPUSD,20,70.80000000000001,2,18,0.9
561926,USDCAD,2,14.030000000000001,0,2,1.0
561926,USDCHF,2,0.1,1,1,0.5
561926,USDJPY,35,1880.47,6,29,0.8285714285714286
561955,AUDJPY,9,-670.08,4,5,0.5555555555555556
561955,AUDUSD,23,-166.46,10,13,0.5652173913043478
561955,EURAUD,2,-65.54,2,0,0.0
561955,EURCHF,16,-35.84,6,10,0.625
561955,EURGBP,3,21.34,0,3,1.0
561955,EURJPY,4,111.34,0,4,1.0
561955,EURUSD,581,-730.64,180,401,0.6901893287435457
561955,GBPCHF,1,-18.54,1,0,0.0
561955,GBPJPY,13,4.270000000000001,4,9,0.6923076923076923
561955,GBPUSD,51,74.9,11,40,0.7843137254901961
561955,USDCAD,17,-95.82000000000001,9,8,0.47058823529411764
561955,USDCHF,23,-729.2499999999999,9,14,0.6086956521739131
561955,USDJPY,36,-1146.67,13,23,0.6388888888888888
561988,AUDJPY,8,2.070000000000002,3,5,0.625
561988,EURJPY,50,-2742.02,9,41,0.82
561988,EURUSD,74,-7161.5,19,55,0.7432432432432432
561988,GBPJPY,162,5276.7,38,124,0.7654320987654321
561988,USDJPY,5,14.700000000000003,2,3,0.6
561988,XAGUSD,1,-1.1,1,0,0.0
562016,AUDCAD,3,-6.32,3,0,0.0
562016,AUDJPY,15,-1472.4799999999998,10,5,0.3333333333333333
562016,AUDUSD,8,-3.5999999999999988,6,2,0.25
562016,CADJPY,8,-3.5700000000000047,6,2,0.25
562016,CHFJPY,1,-7.55,1,0,0.0
562016,EURAUD,13,-226.3,12,1,0.07692307692307693
562016,EURCAD,9,-95.64,6,3,0.3333333333333333
562016,EURCHF,7,7.569999999999999,5,2,0.2857142857142857
562016,EURGBP,5,-104.41999999999999,4,1,0.2
562016,EURJPY,41,-366.61,28,13,0.3170731707317073
562016,EURUSD,7,-14.4,4,3,0.42857142857142855
562016,GBPCHF,6,-26.86,5,1,0.16666666666666666
562016,GBPJPY,8,-15.280000000000008,4,4,0.5
562016,GBPUSD,10,4.6,7,3,0.3
562016,USDCAD,16,192.83999999999997,10,6,0.375
562016,USDCHF,8,-24.45,7,1,0.125
562016,USDJPY,40,5.870000000000022,22,18,0.45
562093,AUDJPY,3,-8.629999999999999,2,1,0.3333333333333333
562093,AUDUSD,26,40.99,18,8,0.3076923076923077
562093,CADJPY,2,-3.08,2,0,0.0
562093,EURGBP,4,-47.42,4,0,0.0
562093,EURJPY,20,-21.660000000000004,11,9,0.45
562093,EURUSD,65,-243.21,46,19,0.2923076923076923
562093,GBPJPY,4,-11.36,3,1,0.25
562093,GBPUSD,66,-96.94,38,28,0.42424242424242425
562093,NZDUSD,5,43.6,3,2,0.4
562093,USDCAD,9,4.249999999999999,6,3,0.3333333333333333
562093,USDCHF,20,-27.450000000000003,12,8,0.4
562093,USDJPY,21,55.11,11,10,0.47619047619047616
562108,EURUSD,439,-13091.4,171,268,0.6104783599088838
562202,EURCHF,3,5.13,0,3,1.0
562202,EURGBP,2,3.7399999999999998,0,2,1.0
562202,EURUSD,608,-1023.2,109,499,0.8207236842105263
562202,GBPJPY,1,1.17,0,1,1.0
562202,GBPUSD,30,-133.29999999999998,15,15,0.5
562202,USDCAD,29,-20.220000000000002,7,22,0.7586206896551724
562202,USDCHF,6,-77.22,3,3,0.5
562202,USDJPY,3,-6.93,2,1,0.3333333333333333
562218,AUDUSD,92,-2197.2,42,50,0.5434782608695652
562218,EURGBP,75,-2068.0499999999997,24,51,0.68
562218,EURUSD,267,380.5,85,182,0.6816479400749064
562218,GBPUSD,238,-691.7,54,184,0.773109243697479
562218,USDCAD,82,-138.93000000000006,17,65,0.7926829268292683
562218,USDCHF,86,-656.1800000000001,32,54,0.627906976744186
562218,USDJPY,88,-2229.43,26,62,0.7045454545454546
562236,AUDNZD,6,-20.74,6,0,0.0
562236,AUDUSD,8,-17.5,3,5,0.625
562236,EURGBP,7,15.85,0,7,1.0
562236,EURJPY,2,2.98,0,2,1.0
562236,EURUSD,204,-177.97,58,146,0.7156862745098039
562236,GBPUSD,11,-18.599999999999998,4,7,0.6363636363636364
562236,NZDUSD,9,-47.3,5,4,0.4444444444444444
562236,USDCAD,14,-13.5,5,9,0.6428571428571429
562236,USDCHF,8,6.640000000000001,1,7,0.875
562236,USDJPY,8,1.1099999999999994,1,7,0.875
562246,AUDJPY,2,13.76,0,2,1.0
562246,AUDUSD,10,104.60000000000001,2,8,0.8
562246,EURGBP,2,3.580000000000002,1,1,0.5
562246,EURJPY,1,4.9,0,1,1.0
562246,EURUSD,142,-1466.5,71,71,0.5
562246,GBPUSD,24,-695.3,9,15,0.625
562246,USDCAD,8,-135.66,7,1,0.125
562246,USDCHF,9,5.090000000000003,4,5,0.5555555555555556
562246,USDJPY,11,-89.73,9,2,0.18181818181818182
562261,AUDUSD,64,-1599.25,8,56,0.875
562261,EURCHF,17,-3301.6499999999996,2,15,0.8823529411764706
562261,EURGBP,23,367.58,2,21,0.9130434782608695
562261,EURJPY,63,-1184.1100000000001,5,58,0.9206349206349206
562261,EURUSD,46,-2929.6,11,35,0.7608695652173914
562261,GBPJPY,340,-4226.5599999999995,34,306,0.9
562261,GBPUSD,58,-4514.4,12,46,0.7931034482758621
562261,NZDUSD,8,109.9,0,8,1.0
562261,USDCAD,40,-114.81000000000002,1,39,0.975
562261,USDCHF,24,-866.7599999999999,4,20,0.8333333333333334
562261,USDJPY,57,-3061.2,9,48,0.8421052631578947
562329,AUDJPY,29,258.37,15,14,0.4827586206896552
562329,AUDUSD,155,171.18,71,84,0.5419354838709678
562329,CADJPY,4,-99.05,3,1,0.25
562329,EURAUD,2,-135.82999999999998,2,0,0.0
562329,EURCHF,6,-50.94,5,1,0.16666666666666666
562329,EURGBP,24,-97.79,16,8,0.3333333333333333
562329,EURJPY,45,-510.2799999999999,23,22,0.4888888888888889
562329,EURUSD,731,-3675.82,377,354,0.4842681258549932
562329,GBPUSD,128,-1001.15,81,47,0.3671875
562329,NZDUSD,13,53.69,6,7,0.5384615384615384
562329,USDCAD,70,-1033.17,33,37,0.5285714285714286
562329,USDCHF,31,-105.98,23,8,0.25806451612903225
562329,USDJPY,64,248.85999999999993,34,30,0.46875
562329,XAGUSD,35,21.94,21,14,0.4
562329,XAUUSD,3,-7.0,3,0,0.0
562332,AUDCAD,11,3.6200000000000006,3,8,0.7272727272727273
562332,AUDUSD,118,-330.54,19,99,0.8389830508474576
562332,EURUSD,669,-615.9,123,546,0.8161434977578476
562332,GBPUSD,45,-109.89999999999999,4,41,0.9111111111111111
562332,USDCAD,829,-758.0,60,769,0.9276236429433052
562332,XAGUSD,3,2.5,0,3,1.0
562486,AUDUSD,5,-9.700000000000001,1,4,0.8
562486,EURCHF,12,-18.25,6,6,0.5
562486,EURGBP,2,3.1599999999999997,0,2,1.0
562486,EURUSD,49,7.57,7,42,0.8571428571428571
562486,GBPJPY,11,-13.5,3,8,0.7272727272727273
562486,GBPUSD,54,-33.17,9,45,0.8333333333333334
562486,USDCAD,3,0.5900000000000001,2,1,0.3333333333333333
562486,USDCHF,31,25.53,7,24,0.7741935483870968
562486,USDJPY,36,-2.999999999999999,11,25,0.6944444444444444
562540,AUDJPY,10,100.11000000000001,4,6,0.6
562540,AUDUSD,16,187.7,7,9,0.5625
562540,CADJPY,3,-209.02,2,1,0.3333333333333333
562540,EURGBP,6,194.70000000000005,2,4,0.6666666666666666
562540,EURJPY,113,-11930.609999999999,45,68,0.6017699115044248
562540,EURUSD,54,-7253.4,16,38,0.7037037037037037
562540,GBPJPY,44,748.63,11,33,0.75
562540,GBPUSD,20,-352.0,8,12,0.6
562540,USDCHF,17,-357.24,8,9,0.5294117647058824
562540,USDJPY,36,-418.0,19,17,0.4722222222222222
562540,XAUUSD,1,27.15,0,1,1.0
562560,GBPUSD,1071,-967.25,216,855,0.7983193277310925
562596,AUDUSD,20,6.6,9,11,0.55
562596,EURCHF,1,2.95,0,1,1.0
562596,EURGBP,15,8.379999999999999,6,9,0.6
562596,EURJPY,7,6.799999999999999,3,4,0.5714285714285714
562596,EURUSD,151,56.39,48,103,0.6821192052980133
562596,GBPJPY,1,-2.29,1,0,0.0
562596,GBPUSD,56,-79.50999999999999,23,33,0.5892857142857143
562596,NZDUSD,1,-4.1,1,0,0.0
562596,USDCAD,13,-0.5699999999999998,7,6,0.46153846153846156
562596,USDCHF,19,13.17,8,11,0.5789473684210527
562596,USDJPY,32,-29.51,10,22,0.6875
562674,AUDCAD,8,-9.71,6,2,0.25
562674,AUDJPY,6,9.259999999999998,3,3,0.5
562674,AUDNZD,15,-25.439999999999998,11,4,0.26666666666666666
562674,AUDUSD,65,-31.439999999999998,39,26,0.4
562674,CADJPY,5,-9.179999999999998,3,2,0.4
562674,CHFJPY,12,-1.7800000000000016,6,6,0.5
562674,EURAUD,13,-22.72,10,3,0.23076923076923078
562674,EURCAD,13,-15.340000000000002,9,4,0.3076923076923077
562674,EURCHF,15,-0.46000000000000174,7,8,0.5333333333333333
562674,EURGBP,3,12.920000000000002,1,2,0.6666666666666666
562674,EURJPY,7,-10.73,5,2,0.2857142857142857
562674,EURUSD,66,-41.41,40,26,0.3939393939393939
562674,GBPCHF,3,-14.51,3,0,0.0
562674,GBPJPY,11,2.2799999999999994,5,6,0.5454545454545454
562674,GBPUSD,69,-23.58,39,30,0.43478260869565216
562674,NZDUSD,19,-7.760000000000002,11,8,0.42105263157894735
562674,USDCAD,33,-33.72,19,14,0.42424242424242425
562674,USDCHF,32,-30.509999999999998,20,12,0.375
562674,USDJPY,11,-6.41,6,5,0.45454545454545453
562689,AUDUSD,40,-697.38,29,11,0.275
562689,EURGBP,5,59.8,1,4,0.8
562689,EURJPY,9,-153.11,3,6,0.6666666666666666
562689,EURUSD,381,-767.97,185,196,0.5144356955380578
562689,GBPJPY,33,-941.72,21,12,0.36363636363636365
562689,GBPUSD,241,-3435.3,112,129,0.5352697095435685
562689,NZDUSD,2,-49.0,2,0,0.0
562689,USDCAD,20,-176.13,9,11,0.55
562689,USDCHF,49,-756.84,28,21,0.42857142857142855
562689,USDJPY,31,71.02,17,14,0.45161290322580644
562692,AUDJPY,33,3.390000000000006,21,12,0.36363636363636365
562692,AUDUSD,259,-1282.98,141,118,0.4555984555984556
562692,CADJPY,4,-1.7400000000000002,2,2,0.5
562692,CHFJPY,1,-5.92,1,0,0.0
562692,EURCAD,6,73.71999999999998,3,3,0.5
562692,EURGBP,12,-53.65,10,2,0.16666666666666666
562692,EURJPY,15,-51.89,9,6,0.4
562692,EURUSD,540,-1010.37,287,253,0.4685185185185185
562692,GBPJPY,6,-41.19,5,1,0.16666666666666666
562692,GBPUSD,773,-2021.1299999999999,460,313,0.4049159120310479
562692,NZDUSD,593,-1827.3400000000001,340,253,0.4266441821247892
562692,USDCAD,32,451.74,17,15,0.46875
562692,USDCHF,11,40.33,5,6,0.5454545454545454
562692,USDJPY,86,178.62999999999997,52,34,0.3953488372093023
562692,XAGUSD,107,-2080.6,73,34,0.3177570093457944
562692,XAUUSD,1,1.05,0,1,1.0
562825,AUDUSD,134,-940.7,21,113,0.8432835820895522
562825,EURGBP,1,-12.48,1,0,0.0
562825,EURUSD,155,-768.1,27,128,0.8258064516129032
562825,GBPUSD,26,21.9,5,21,0.8076923076923077
562825,USDCAD,4,5.6899999999999995,0,4,1.0
562825,USDCHF,55,-319.33,14,41,0.7454545454545455
562825,USDJPY,8,-43.81999999999999,2,6,0.75
562937,EURUSD,221,-15762.6,45,176,0.7963800904977375
562937,GBPUSD,16,-2359.8,8,8,0.5
562939,EURUSD,288,-725.5,101,187,0.6493055555555556
562939,GBPJPY,2,-16.38,1,1,0.5
562939,GBPUSD,75,-409.0,26,49,0.6533333333333333
562945,EURUSD,136,-12273.5,26,110,0.8088235294117647
562945,GBPUSD,34,885.6999999999999,6,28,0.8235294117647058
562952,AUDCAD,4,-166.03,4,0,0.0
562952,AUDJPY,23,-136.03000000000003,7,16,0.6956521739130435
562952,AUDNZD,6,3944.55,0,6,1.0
562952,AUDUSD,41,11.099999999999909,22,19,0.4634146341463415
562952,EURAUD,8,1314.3600000000001,2,6,0.75
562952,EURCAD,1,0.96,0,1,1.0
562952,EURCHF,1,-104.39,1,0,0.0
562952,EURGBP,13,-667.82,8,5,0.38461538461538464
562952,EURJPY,6,1524.4300000000003,1,5,0.8333333333333334
562952,EURUSD,110,7880.6,42,68,0.6181818181818182
562952,GBPCHF,6,-91.57,2,4,0.6666666666666666
562952,GBPJPY,12,21.079999999999984,7,5,0.4166666666666667
562952,GBPUSD,118,-3782.1,66,52,0.4406779661016949
562952,NZDUSD,2,-521.0,1,1,0.5
562952,USDCAD,10,-1012.6700000000001,3,7,0.7
562952,USDCHF,14,962.56,3,11,0.7857142857142857
562952,USDJPY,21,1929.1,4,17,0.8095238095238095
562952,USDTRY,3,-32.84,3,0,0.0
562952,XAGUSD,9,10731.9,0,9,1.0
563167,AUDCAD,1,1.55,0,1,1.0
563167,AUDJPY,2,7.159999999999999,0,2,1.0
563167,AUDUSD,17,1.7,10,7,0.4117647058823529
563167,EURAUD,6,27.669999999999998,3,3,0.5
563167,EURCAD,2,5.140000000000001,0,2,1.0
563167,EURCHF,1,-2.5,1,0,0.0
563167,EURGBP,3,15.67,0,3,1.0
563167,EURJPY,4,-1.3399999999999999,1,3,0.75
563167,EURUSD,20,1.6999999999999986,15,5,0.25
563167,GBPCHF,3,-53.339999999999996,1,2,0.6666666666666666
563167,GBPUSD,7,-14.0,7,0,0.0
563167,NZDUSD,14,-62.300000000000004,7,7,0.5
563167,USDCAD,16,-17.32,13,3,0.1875
563167,USDCHF,10,-175.48999999999998,4,6,0.6
563167,USDJPY,11,12.74,6,5,0.45454545454545453
563167,XAGUSD,51,-24.1,27,24,0.47058823529411764
563167,XAUUSD,52,-45.68,31,21,0.40384615384615385
563179,AUDNZD,3,-8.55,2,1,0.3333333333333333
563179,EURCAD,3,65.36,2,1,0.3333333333333333
563179,EURGBP,1,25.76,0,1,1.0
563179,EURUSD,930,-15662.15,451,479,0.5150537634408602
563179,GBPCHF,1,44.21,0,1,1.0
563179,GBPUSD,7,-1085.69,5,2,0.2857142857142857
563179,USDCAD,12,-23.400000000000002,8,4,0.3333333333333333
563179,USDCHF,1,-28.55,1,0,0.0
563179,USDJPY,4,-64.41,3,1,0.25
563267,AUDUSD,3,-12.0,2,1,0.3333333333333333
563267,EURJPY,29,-427.68,10,19,0.6551724137931034
563267,EURUSD,46,-199.34000000000003,7,39,0.8478260869565217
563267,GBPUSD,28,-16.899999999999995,5,23,0.8214285714285714
563267,USDCAD,2,41.15,1,1,0.5
563267,USDJPY,10,-124.41999999999999,5,5,0.5
563281,AUDJPY,27,-45.64,18,9,0.3333333333333333
563281,AUDUSD,34,-59.33,24,10,0.29411764705882354
563281,CADJPY,8,2.26,6,2,0.25
563281,CHFJPY,2,-1.01,2,0,0.0
563281,EURAUD,1,-0.93,1,0,0.0
563281,EURCAD,43,10.31,28,15,0.3488372093023256
563281,EURCHF,5,-10.459999999999999,3,2,0.4
563281,EURGBP,20,-27.59,14,6,0.3
563281,EURJPY,41,-39.02,24,17,0.4146341463414634
563281,EURUSD,46,-26.11,32,14,0.30434782608695654
563281,GBPJPY,31,23.249999999999996,18,13,0.41935483870967744
563281,GBPUSD,103,-89.97,62,41,0.39805825242718446
563281,NZDUSD,43,-1.5000000000000018,25,18,0.4186046511627907
563281,USDCAD,17,-14.730000000000002,12,5,0.29411764705882354
563281,USDCHF,33,-30.81,24,9,0.2727272727272727
563281,USDJPY,35,-13.01,21,14,0.4
563500,AUDCAD,3,-1054.36,1,2,0.6666666666666666
563500,AUDUSD,2,7.05,0,2,1.0
563500,CADJPY,1,4.83,0,1,1.0
563500,EURGBP,12,-642.27,4,8,0.6666666666666666
563500,EURJPY,3,-2013.18,2,1,0.3333333333333333
563500,EURUSD,167,-6185.7,60,107,0.6407185628742516
563500,GBPUSD,42,421.4,8,34,0.8095238095238095
563500,NZDUSD,1,9.6,0,1,1.0
563500,USDCAD,78,-1117.52,24,54,0.6923076923076923
563500,USDCHF,6,-958.67,2,4,0.6666666666666666
563500,USDJPY,3,640.26,1,2,0.6666666666666666
563500,XAGUSD,4,115.0,2,2,0.5
563500,XAUUSD,1,125.0,0,1,1.0
563743,AUDCAD,1,157.34,0,1,1.0
563743,AUDJPY,36,-419.47999999999985,18,18,0.5
563743,AUDNZD,2,-90.13999999999999,1,1,0.5
563743,AUDUSD,47,-2714.0,30,17,0.3617021276595745
563743,CADJPY,5,2161.3,0,5,1.0
563743,CHFJPY,15,-169.10999999999996,4,11,0.7333333333333333
563743,EURAUD,14,11006.57,0,14,1.0
563743,EURCAD,3,113.77000000000001,1,2,0.6666666666666666
563743,EURCHF,1,5.15,0,1,1.0
563743,EURGBP,1,112.32,0,1,1.0
563743,EURJPY,65,-2821.3399999999992,26,39,0.6
563743,EURUSD,173,-14278.1,68,105,0.6069364161849711
563743,GBPJPY,31,3576.5,11,20,0.6451612903225806
563743,GBPUSD,133,-11237.9,51,82,0.6165413533834586
563743,NZDUSD,5,-471.5,2,3,0.6
563743,USDCAD,14,4156.86,3,11,0.7857142857142857
563743,USDCHF,19,-153.95,5,14,0.7368421052631579
563743,USDJPY,21,1010.9199999999997,10,11,0.5238095238095238
563772,AUDCAD,25,-287.91,18,7,0.28
563772,AUDJPY,84,25.599999999999984,45,39,0.4642857142857143
563772,AUDUSD,120,-336.06,68,52,0.43333333333333335
563772,CADJPY,37,-279.84,19,18,0.4864864864864865
563772,CHFJPY,34,-209.81000000000003,17,17,0.5
563772,EURAUD,1,3.98,0,1,1.0
563772,EURCAD,28,-33.11,19,9,0.32142857142857145
563772,EURCHF,7,3.5999999999999988,1,6,0.8571428571428571
563772,EURGBP,64,-127.55000000000003,39,25,0.390625
563772,EURJPY,194,-619.36,115,79,0.4072164948453608
563772,EURUSD,389,-180.03,221,168,0.4318766066838046
563772,GBPCHF,37,-245.13,27,10,0.2702702702702703
563772,GBPJPY,214,-341.49,128,86,0.40186915887850466
563772,GBPUSD,195,-402.68,96,99,0.5076923076923077
563772,NZDUSD,15,-57.5,10,5,0.3333333333333333
563772,USDCAD,68,49.88,32,36,0.5294117647058824
563772,USDCHF,214,-182.68,130,84,0.3925233644859813
563772,USDJPY,75,78.47,40,35,0.4666666666666667
563772,XAGUSD,2,-45.0,2,0,0.0
563772,XAUUSD,1,-67.9,1,0,0.0
563818,AUDUSD,27,-158.6,6,21,0.7777777777777778
563818,EURGBP,1,-1.5,1,0,0.0
563818,EURJPY,46,-45.88,18,28,0.6086956521739131
563818,EURUSD,107,-223.6,26,81,0.7570093457943925
563818,GBPUSD,79,-346.4,29,50,0.6329113924050633
563818,NZDUSD,4,-3.7,2,2,0.5
563818,USDCAD,16,-23.85,7,9,0.5625
563818,USDCHF,52,-5.4200000000000035,21,31,0.5961538461538461
563818,USDJPY,25,-11.650000000000002,11,14,0.56
563819,EURUSD,118,-1482.3,42,76,0.6440677966101694
563819,GBPUSD,5,-140.0,4,1,0.2
563819,USDCHF,2,-36.83,2,0,0.0
563819,XAUUSD,1,0.11,0,1,1.0
563827,AUDUSD,17,-73.12,10,7,0.4117647058823529
563827,CHFJPY,10,47.64,3,7,0.7
563827,EURGBP,1,-22.72,1,0,0.0
563827,EURJPY,8,-38.16,4,4,0.5
563827,EURUSD,75,-148.66,45,30,0.4
563827,GBPUSD,56,-449.0,35,21,0.375
563827,NZDUSD,8,66.1,4,4,0.5
563827,USDCAD,9,32.769999999999996,4,5,0.5555555555555556
563827,USDCHF,19,-52.19,12,7,0.3684210526315789
563827,USDJPY,22,-51.349999999999994,12,10,0.45454545454545453
563827,XAUUSD,13,-103.6,9,4,0.3076923076923077
563836,AUDCAD,5,-11.58,2,3,0.6
563836,AUDNZD,11,-6.209999999999999,5,6,0.5454545454545454
563836,AUDUSD,2,-0.8,1,1,0.5
563836,EURAUD,12,-30.900000000000002,6,6,0.5
563836,EURCAD,19,-34.93,9,10,0.5263157894736842
563836,EURCHF,16,-4.970000000000001,6,10,0.625
563836,EURGBP,15,-9.859999999999996,5,10,0.6666666666666666
563836,EURJPY,1,-12.02,1,0,0.0
563836,EURUSD,903,-187.71,322,581,0.6434108527131783
563836,GBPCHF,1,21.23,0,1,1.0
563836,GBPUSD,11,-35.6,8,3,0.2727272727272727
563836,XAUUSD,9,1.5499999999999998,1,8,0.8888888888888888
563864,AUDCAD,6,-44.47,4,2,0.3333333333333333
563864,AUDJPY,1,-0.34,1,0,0.0
563864,AUDNZD,4,0.9100000000000001,2,2,0.5
563864,AUDUSD,23,-37.300000000000004,11,12,0.5217391304347826
563864,CADJPY,3,-92.54,2,1,0.3333333333333333
563864,EURAUD,94,-520.85,38,56,0.5957446808510638
563864,EURCAD,8,-141.12,5,3,0.375
563864,EURCHF,2,-25.72,1,1,0.5
563864,EURGBP,12,-261.38,7,5,0.4166666666666667
563864,EURJPY,29,-185.06,19,10,0.3448275862068966
563864,EURUSD,176,-626.71,86,90,0.5113636363636364
563864,GBPCHF,4,2.9399999999999977,2,2,0.5
563864,GBPJPY,19,-546.4699999999999,11,8,0.42105263157894735
563864,GBPUSD,59,120.83000000000001,23,36,0.6101694915254238
563864,NZDUSD,8,-367.3,5,3,0.375
563864,USDCAD,12,8.050000000000004,6,6,0.5
563864,USDCHF,71,-274.83,43,28,0.39436619718309857
563864,USDJPY,23,-101.75,14,9,0.391304347826087
563918,EURUSD,126,-71.2,21,105,0.8333333333333334
563927,AUDJPY,6,-15.6,5,1,0.16666666666666666
563927,AUDUSD,47,-56.06,21,26,0.5531914893617021
563927,CADJPY,1,-4.51,1,0,0.0
563927,CHFJPY,1,0.12,0,1,1.0
563927,EURAUD,1,-0.39,1,0,0.0
563927,EURCHF,2,1.48,0,2,1.0
563927,EURGBP,15,-191.06,10,5,0.3333333333333333
563927,EURJPY,18,-74.84,8,10,0.5555555555555556
563927,EURUSD,341,-1989.4099999999999,142,199,0.5835777126099707
563927,GBPJPY,228,-217.84999999999997,58,170,0.7456140350877193
563927,GBPUSD,152,278.15,53,99,0.6513157894736842
563927,NZDUSD,16,-12.52,6,10,0.625
563927,USDCAD,23,26.679999999999996,8,15,0.6521739130434783
563927,USDCHF,22,-97.99999999999999,6,16,0.7272727272727273
563927,USDJPY,7,2.0100000000000007,3,4,0.5714285714285714
564092,AUDCAD,34,14.569999999999991,2,32,0.9411764705882353
564092,AUDJPY,58,-43.08,12,46,0.7931034482758621
564092,AUDUSD,10,54.8,0,10,1.0
564092,CADJPY,6,11.51,1,5,0.8333333333333334
564092,CHFJPY,12,52.459999999999994,0,12,1.0
564092,EURAUD,1,3.84,0,1,1.0
564092,EURCAD,15,40.65,0,15,1.0
564092,EURCHF,21,123.36999999999999,1,20,0.9523809523809523
564092,EURGBP,37,-113.99999999999999,9,28,0.7567567567567568
564092,EURJPY,28,-45.24999999999999,4,24,0.8571428571428571
564092,EURUSD,429,-724.0799999999999,21,408,0.951048951048951
564092,GBPCHF,16,-22.330000000000002,2,14,0.875
564092,GBPJPY,65,-254.86999999999998,10,55,0.8461538461538461
564092,GBPUSD,37,-299.01,4,33,0.8918918918918919
564092,NZDUSD,21,46.1,1,20,0.9523809523809523
564092,USDCAD,17,-1.6700000000000013,3,14,0.8235294117647058
564092,USDCHF,9,40.22,0,9,1.0
564092,USDJPY,23,-50.12,1,22,0.9565217391304348
564154,AUDJPY,1,-8.89,1,0,0.0
564154,AUDUSD,2,-10.0,2,0,0.0
564154,EURAUD,1,-20.18,1,0,0.0
564154,EURGBP,1,2.99,0,1,1.0
564154,EURJPY,1,7.78,0,1,1.0
564154,EURUSD,185,-39.1,73,112,0.6054054054054054
564154,GBPJPY,1,1.11,0,1,1.0
564154,GBPUSD,363,-721.49,161,202,0.5564738292011019
564154,NZDUSD,1,-9.0,1,0,0.0
564154,USDCAD,1,5.85,0,1,1.0
564154,USDCHF,4,-4.5,3,1,0.25
564249,AUDUSD,38,-4761.2,12,26,0.6842105263157895
564249,CADJPY,1,16.54,0,1,1.0
564249,CHFJPY,2,-10.740000000000002,1,1,0.5
564249,EURAUD,1,-108.57,1,0,0.0
564249,EURCAD,2,19.880000000000003,0,2,1.0
564249,EURCHF,6,-182.96,2,4,0.6666666666666666
564249,EURGBP,7,102.48000000000002,3,4,0.5714285714285714
564249,EURJPY,28,-456.52,15,13,0.4642857142857143
564249,EURUSD,53,516.61,20,33,0.6226415094339622
564249,GBPCHF,8,-1.5999999999999959,1,7,0.875
564249,GBPJPY,41,590.82,15,26,0.6341463414634146
564249,GBPUSD,39,-1474.1,23,16,0.41025641025641024
564249,USDCAD,14,674.31,5,9,0.6428571428571429
564249,USDCHF,33,-75.1,10,23,0.696969696969697
564249,USDJPY,18,-57.75000000000003,11,7,0.3888888888888889
564268,AUDJPY,6,-457.78,2,4,0.6666666666666666
564268,AUDUSD,44,-176.10000000000002,14,30,0.6818181818181818
564268,EURUSD,171,-931.5,46,125,0.7309941520467836
564268,GBPJPY,170,-1160.14,27,143,0.8411764705882353
564268,GBPUSD,24,-74.4,6,18,0.75
564268,USDCAD,82,164.32000000000002,21,61,0.7439024390243902
564268,USDCHF,10,-20.93,3,7,0.7
564268,USDJPY,65,671.25,16,49,0.7538461538461538
564290,AUDUSD,18,-59.22,11,7,0.3888888888888889
564290,EURUSD,320,-1496.65,199,121,0.378125
564290,GBPUSD,13,47.83,4,9,0.6923076923076923
564290,USDCAD,147,-254.40999999999997,88,59,0.4013605442176871
564290,USDCHF,11,-55.68,8,3,0.2727272727272727
564290,USDJPY,10,11.379999999999999,4,6,0.6
564290,XAGUSD,52,-96.34,34,18,0.34615384615384615
564290,XAUUSD,30,-116.47999999999999,21,9,0.3
564297,AUDUSD,14,-688.3999999999999,3,11,0.7857142857142857
564297,EURJPY,5,-244.66,2,3,0.6
564297,EURUSD,42,-112.90000000000003,19,23,0.5476190476190477
564297,GBPJPY,4,-109.2,2,2,0.5
564297,GBPUSD,21,-400.7,10,11,0.5238095238095238
564297,USDCAD,1,4.6,0,1,1.0
564297,USDCHF,12,-9.960000000000008,5,7,0.5833333333333334
564297,USDJPY,4,-1118.82,4,0,0.0
564301,AUDUSD,5,-33.4,3,2,0.4
564301,EURUSD,212,-478.9,123,89,0.419811320754717
564301,GBPUSD,1,-4.5,1,0,0.0
564301,XAUUSD,2,-1.1,1,1,0.5
564315,AUDCAD,3,-47.120000000000005,3,0,0.0
564315,AUDJPY,4,15.360000000000001,1,3,0.75
564315,AUDUSD,5,-115.0,3,2,0.4
564315,CADJPY,5,88.06,0,5,1.0
564315,CHFJPY,3,-95.31,3,0,0.0
564315,EURAUD,5,-53.910000000000004,3,2,0.4
564315,EURCAD,6,-39.58,4,2,0.3333333333333333
564315,EURCHF,3,-28.599999999999998,2,1,0.3333333333333333
564315,EURGBP,3,-27.64,2,1,0.3333333333333333
564315,EURJPY,9,-190.42,7,2,0.2222222222222222
564315,EURUSD,20,-83.0,10,10,0.5
564315,GBPCHF,2,-30.72,2,0,0.0
564315,GBPJPY,15,-11.339999999999991,9,6,0.4
564315,GBPUSD,19,-64.7,9,10,0.5263157894736842
564315,NZDUSD,1,-29.0,1,0,0.0
564315,USDCAD,5,-33.14,4,1,0.2
564315,USDCHF,12,-103.62,6,6,0.5
564315,USDJPY,5,-9.920000000000002,3,2,0.4
564315,USDTRY,1,-40.08,1,0,0.0
564373,AUDUSD,12,-665.8,6,6,0.5
564373,CADJPY,11,-2095.76,4,7,0.6363636363636364
564373,CHFJPY,4,105.36,2,2,0.5
564373,EURAUD,3,324.25,0,3,1.0
564373,EURCHF,9,-17.529999999999994,3,6,0.6666666666666666
564373,EURGBP,10,-528.93,4,6,0.6
564373,EURJPY,10,-815.47,4,6,0.6
564373,EURUSD,56,-1188.1,16,40,0.7142857142857143
564373,GBPCHF,7,72.22999999999999,2,5,0.7142857142857143
564373,GBPJPY,3,-595.74,2,1,0.3333333333333333
564373,GBPUSD,19,316.1,7,12,0.631578947368421
564373,NZDUSD,13,-856.0,9,4,0.3076923076923077
564373,USDCAD,8,-772.96,3,5,0.625
564373,USDCHF,8,546.73,1,7,0.875
564373,USDJPY,103,-10200.77,44,59,0.5728155339805825
564373,XAUUSD,4,-382.80000000000007,2,2,0.5
564388,AUDUSD,3,-154.24,3,0,0.0
564388,EURJPY,2,-10.42,2,0,0.0
564388,EURUSD,265,-344.9099999999999,179,86,0.32452830188679244
564388,GBPJPY,1,-10.7,1,0,0.0
564388,GBPUSD,4,-103.78,4,0,0.0
564388,NZDUSD,7,131.04999999999998,2,5,0.7142857142857143
564388,USDCHF,2,-70.15,2,0,0.0
564388,USDJPY,23,-259.86,15,8,0.34782608695652173
564599,AUDUSD,3,-13.0,1,2,0.6666666666666666
564599,CADJPY,21,-473.69,9,12,0.5714285714285714
564599,CHFJPY,4,43.19,1,3,0.75
564599,EURCAD,7,-47.760000000000005,3,4,0.5714285714285714
564599,EURCHF,11,-67.53,5,6,0.5454545454545454
564599,EURJPY,5,19.19,1,4,0.8
564599,EURUSD,34,-106.69999999999999,13,21,0.6176470588235294
564599,GBPJPY,62,-269.52,22,40,0.6451612903225806
564599,GBPUSD,13,24.900000000000006,3,10,0.7692307692307693
564599,NZDUSD,1,6.0,0,1,1.0
564599,USDCAD,7,-8.46,3,4,0.5714285714285714
564599,USDCHF,15,-118.17,6,9,0.6
564599,USDJPY,12,-47.919999999999995,4,8,0.6666666666666666
564624,EURCAD,2,3.77,0,2,1.0
564624,EURUSD,358,-3631.39,154,204,0.5698324022346368
564624,GBPUSD,1,2.4,0,1,1.0
564624,USDCAD,18,13.380000000000003,2,16,0.8888888888888888
564624,USDCHF,1,19.77,0,1,1.0
564741,AUDCAD,3,-4.42,2,1,0.3333333333333333
564741,AUDUSD,28,126.69999999999999,11,17,0.6071428571428571
564741,CHFJPY,33,26.43,13,20,0.6060606060606061
564741,EURAUD,37,-344.27,24,13,0.35135135135135137
564741,EURCAD,18,-114.04,15,3,0.16666666666666666
564741,EURCHF,4,6.080000000000002,1,3,0.75
564741,EURGBP,1,-5.35,1,0,0.0
564741,EURJPY,128,14.190000000000008,58,70,0.546875
564741,EURUSD,154,-1092.6,81,73,0.474025974025974
564741,GBPCHF,1,-2.48,1,0,0.0
564741,GBPJPY,3,8.88,2,1,0.3333333333333333
564741,GBPUSD,104,-6.899999999999995,43,61,0.5865384615384616
564741,NZDUSD,81,21.099999999999994,39,42,0.5185185185185185
564741,USDCAD,8,55.93000000000001,2,6,0.75
564741,USDCHF,24,-714.19,14,10,0.4166666666666667
564741,USDJPY,152,-368.65000000000003,85,67,0.4407894736842105
564741,XAGUSD,3,-1.1999999999999993,1,2,0.6666666666666666
564741,XAUUSD,408,-3313.37,221,187,0.4583333333333333
564803,EURUSD,134,-1828.45,45,89,0.664179104477612
564803,GBPUSD,12,3.899999999999997,3,9,0.75
564803,USDCHF,2,13.52,0,2,1.0
564854,EURUSD,1223,-204.35999999999999,496,727,0.5944399018806215
564854,GBPUSD,135,-127.1,58,77,0.5703703703703704
564854,USDCAD,1,-0.77,1,0,0.0
564854,USDCHF,40,-213.5,20,20,0.5
564854,USDJPY,25,-13.149999999999997,10,15,0.6
564874,EURCAD,1,0.39,0,1,1.0
564874,EURCHF,5,21.31,2,3,0.6
564874,EURUSD,193,257.33000000000004,117,76,0.39378238341968913
564953,EURUSD,164,-446.85,78,86,0.524390243902439
564971,AUDUSD,22,-47.39999999999999,8,14,0.6363636363636364
564971,EURGBP,1,5.18,0,1,1.0
564971,EURJPY,2,21.68,0,2,1.0
564971,EURUSD,183,137.66000000000003,59,124,0.6775956284153005
564971,GBPJPY,4,-115.73,2,2,0.5
564971,GBPUSD,48,-158.55,21,27,0.5625
564971,USDCAD,3,-28.009999999999998,2,1,0.3333333333333333
564971,USDCHF,1,-18.67,1,0,0.0
564971,USDJPY,2,6.35,1,1,0.5
565021,EURUSD,259,-26.65,67,192,0.7413127413127413
565097,AUDUSD,135,-2308.3000000000006,31,104,0.7703703703703704
565097,EURUSD,116,1603.92,34,82,0.7068965517241379
565097,GBPUSD,102,-4839.2,26,76,0.7450980392156863
565097,USDCAD,2,-4.99,1,1,0.5
565097,USDCHF,2,13.27,0,2,1.0
565097,USDJPY,27,-1159.57,10,17,0.6296296296296297
565215,AUDNZD,1,1.09,0,1,1.0
565215,AUDUSD,8,-10.2,3,5,0.625
565215,EURAUD,1,-4.71,1,0,0.0
565215,EURCHF,9,-21.9,6,3,0.3333333333333333
565215,EURGBP,57,-44.540000000000006,24,33,0.5789473684210527
565215,EURJPY,3,-30.189999999999998,2,1,0.3333333333333333
565215,EURUSD,175,-173.10000000000002,75,100,0.5714285714285714
565215,GBPCHF,2,-2.1200000000000006,1,1,0.5
565215,GBPJPY,2,-2.39,1,1,0.5
565215,GBPUSD,96,-342.27,40,56,0.5833333333333334
565215,USDCAD,7,-37.089999999999996,4,3,0.42857142857142855
565215,USDCHF,15,-86.26,7,8,0.5333333333333333
565215,USDJPY,18,-16.39,10,8,0.4444444444444444
565215,USDTRY,1,-7.35,1,0,0.0
565215,XAGUSD,1,-5.4,1,0,0.0
565224,AUDCAD,4,-15.42,2,2,0.5
565224,AUDNZD,5,4.02,0,5,1.0
565224,AUDUSD,8,-43.52,2,6,0.75
565224,CADJPY,2,-100.59,2,0,0.0
565224,EURCAD,6,-6.17,1,5,0.8333333333333334
565224,EURCHF,4,-12.39,1,3,0.75
565224,EURGBP,10,-97.22,4,6,0.6
565224,EURUSD,102,-349.69,27,75,0.7352941176470589
565224,GBPCHF,4,-25.12,2,2,0.5
565224,GBPUSD,15,124.95,2,13,0.8666666666666667
565224,NZDUSD,1,-28.14,1,0,0.0
565224,USDCAD,12,-31.250000000000007,3,9,0.75
565224,USDCHF,5,-2.59,3,2,0.4
565224,USDMXN,3,-2.6700000000000004,2,1,0.3333333333333333
565331,EURUSD,644,-297.73,281,363,0.5636645962732919
565331,GBPUSD,27,-15.009999999999998,14,13,0.48148148148148145
565331,USDCHF,14,-2.8499999999999996,4,10,0.7142857142857143
565331,USDJPY,14,104.25,3,11,0.7857142857142857
565332,EURUSD,365,1336.61,146,219,0.6
565332,GBPUSD,61,-796.66,29,32,0.5245901639344263
565332,USDCAD,4,208.04,2,2,0.5
565332,USDCHF,2,-28.070000000000004,1,1,0.5
565332,USDJPY,8,-41.86,4,4,0.5
565366,AUDUSD,32,-37.78,18,14,0.4375
565366,EURGBP,3,3.05,0,3,1.0
565366,EURUSD,90,-293.89,57,33,0.36666666666666664
565366,GBPUSD,39,-36.66,23,16,0.41025641025641024
565366,USDCAD,14,6.330000000000001,5,9,0.6428571428571429
565366,USDCHF,11,-16.41,6,5,0.45454545454545453
565366,USDJPY,17,-23.06,13,4,0.23529411764705882
565366,XAGUSD,73,-98.34,41,32,0.4383561643835616
565366,XAUUSD,327,-648.2,175,152,0.4648318042813456
565555,AUDUSD,25,-9.7,7,18,0.72
565555,EURCHF,2,1.3299999999999998,1,1,0.5
565555,EURJPY,29,-52.7,8,21,0.7241379310344828
565555,EURUSD,2299,-6177.15,601,1698,0.7385819921705089
565555,GBPJPY,2,3.83,0,2,1.0
565555,GBPUSD,26,-65.36,7,19,0.7307692307692307
565555,USDCAD,36,-64.22,12,24,0.6666666666666666
565555,USDCHF,4,-1.7399999999999993,1,3,0.75
565555,USDJPY,66,-45.57,32,34,0.5151515151515151
565555,XAGUSD,486,-824.93,187,299,0.6152263374485597
565609,AUDUSD,3,16.6,1,2,0.6666666666666666
565609,EURCHF,1,80.66,0,1,1.0
565609,EURUSD,228,-874.72,98,130,0.5701754385964912
565609,GBPUSD,5,-10.229999999999999,3,2,0.4
565609,USDCAD,11,-67.81,8,3,0.2727272727272727
565609,USDCHF,3,24.93,1,2,0.6666666666666666
565697,AUDUSD,2,-0.4899999999999993,1,1,0.5
565697,EURUSD,162,-1176.1499999999999,52,110,0.6790123456790124
565697,USDCHF,2,-41.55,2,0,0.0
565771,AUDJPY,1,11.09,0,1,1.0
565771,AUDUSD,2,-55.6,2,0,0.0
565771,EURGBP,3,-80.71000000000001,2,1,0.3333333333333333
565771,EURJPY,5,-2.089999999999999,4,1,0.2
565771,EURUSD,267,1013.9,141,126,0.47191011235955055
565771,GBPUSD,1,-15.2,1,0,0.0
565771,NZDUSD,4,-15.0,4,0,0.0
565771,USDCHF,4,62.269999999999996,2,2,0.5
565771,USDJPY,3,4.17,1,2,0.6666666666666666
565799,AUDUSD,22,486.2,8,14,0.6363636363636364
565799,EURAUD,1,-3.16,1,0,0.0
565799,EURCAD,1,-37.77,1,0,0.0
565799,EURCHF,21,-873.26,11,10,0.47619047619047616
565799,EURGBP,2,0.6200000000000001,1,1,0.5
565799,EURJPY,6,-132.29,2,4,0.6666666666666666
565799,EURUSD,1107,-1929.7,171,936,0.8455284552845529
565799,GBPJPY,1,5.41,0,1,1.0
565799,GBPUSD,36,-49.6,20,16,0.4444444444444444
565799,NZDUSD,2,-191.89999999999998,1,1,0.5
565799,USDCAD,10,-13.469999999999999,3,7,0.7
565799,USDCHF,27,-157.16,12,15,0.5555555555555556
565799,USDJPY,17,-259.72,9,8,0.47058823529411764
565855,AUDUSD,120,-819.1899999999999,45,75,0.625
565855,EURUSD,118,-846.95,42,76,0.6440677966101694
565855,GBPUSD,53,-115.73999999999998,21,32,0.6037735849056604
565855,USDCHF,126,52.93000000000001,25,101,0.8015873015873016
565855,USDJPY,135,158.70000000000002,25,110,0.8148148148148148
565857,AUDUSD,3,-142.0,1,2,0.6666666666666666
565857,EURAUD,2,-70.83,2,0,0.0
565857,EURUSD,41,-163.5,23,18,0.43902439024390244
565857,GBPUSD,70,-719.2,33,37,0.5285714285714286
565857,NZDUSD,4,4.5,3,1,0.25
565900,AUDUSD,127,-222.8,16,111,0.8740157480314961
565900,EURCHF,1,1.9,0,1,1.0
565900,EURUSD,653,-2245.3,90,563,0.8621745788667687
565900,GBPUSD,140,176.9,25,115,0.8214285714285714
565900,USDCAD,17,-170.01,7,10,0.5882352941176471
565900,USDCHF,11,-10.819999999999993,3,8,0.7272727272727273
565900,USDJPY,1,3.24,0,1,1.0
565969,AUDUSD,7,-54.800000000000004,4,3,0.42857142857142855
565969,EURJPY,15,-640.49,7,8,0.5333333333333333
565969,EURUSD,46,29.349999999999994,12,34,0.7391304347826086
565969,GBPUSD,69,-230.0,25,44,0.6376811594202898
565969,USDCAD,4,58.900000000000006,0,4,1.0
565982,EURGBP,1,-13.13,1,0,0.0
565982,EURJPY,132,1082.74,38,94,0.7121212121212122
565982,EURUSD,189,-2415.9,82,107,0.5661375661375662
565982,GBPJPY,1,-197.11,1,0,0.0
565982,GBPUSD,48,-1272.3,15,33,0.6875
565982,USDCAD,10,52.44,3,7,0.7
565982,USDJPY,31,215.87,9,22,0.7096774193548387
566028,EURUSD,890,-3254.98,467,423,0.4752808988764045
566028,USDJPY,6,6.379999999999999,4,2,0.3333333333333333
566028,XAGUSD,238,-2407.4,172,66,0.2773109243697479
566028,XAUUSD,3005,-18787.670000000002,1880,1125,0.37437603993344426
566062,AUDNZD,61,-1459.2,23,38,0.6229508196721312
566062,AUDUSD,1,3.0,0,1,1.0
566062,EURUSD,529,139.22000000000006,45,484,0.9149338374291115
566062,GBPUSD,377,2883.8700000000003,23,354,0.9389920424403183
566062,NZDUSD,180,-739.94,27,153,0.85
566062,USDCHF,187,-5122.43,38,149,0.7967914438502673
566062,XAGUSD,184,-4772.86,45,139,0.7554347826086957
566062,XAUUSD,285,-4878.6,40,245,0.8596491228070176
566143,AUDUSD,2,-12.8,1,1,0.5
566143,EURGBP,38,-286.18,21,17,0.4473684210526316
566143,EURJPY,5,6.25,0,5,1.0
566143,EURUSD,38,-130.92999999999998,5,33,0.868421052631579
566143,GBPJPY,5,-4.470000000000001,1,4,0.8
566143,GBPUSD,8,2.9399999999999995,2,6,0.75
566143,NZDUSD,1,-9.05,1,0,0.0
566143,USDCAD,1,1.02,0,1,1.0
566143,USDCHF,2,2.21,0,2,1.0
566143,USDJPY,39,-44.879999999999995,12,27,0.6923076923076923
566371,EURUSD,463,-294.93,86,377,0.8142548596112311
566389,EURCHF,465,-254.73000000000002,119,346,0.7440860215053764
566389,EURUSD,763,368.09,140,623,0.8165137614678899
566389,USDCHF,378,-782.66,109,269,0.7116402116402116
566466,AUDJPY,29,-146.72,16,13,0.4482758620689655
566466,AUDUSD,128,-345.54999999999995,54,74,0.578125
566466,CADJPY,9,-218.24,7,2,0.2222222222222222
566466,CHFJPY,80,-556.0699999999999,35,45,0.5625
566466,EURAUD,6,-104.72999999999999,5,1,0.16666666666666666
566466,EURCAD,34,-473.11,17,17,0.5
566466,EURCHF,19,-625.4,8,11,0.5789473684210527
566466,EURGBP,53,-232.07999999999998,33,20,0.37735849056603776
566466,EURJPY,243,-2087.36,97,146,0.6008230452674898
566466,EURUSD,438,-1347.3,155,283,0.6461187214611872
566466,GBPCHF,54,-366.30999999999995,20,34,0.6296296296296297
566466,GBPJPY,128,-1392.08,64,64,0.5
566466,GBPUSD,329,-1493.25,124,205,0.6231003039513677
566466,NZDUSD,59,-522.65,32,27,0.4576271186440678
566466,USDCAD,178,-752.89,85,93,0.5224719101123596
566466,USDCHF,150,-780.4200000000001,66,84,0.56
566466,USDJPY,158,-933.25,86,72,0.45569620253164556
566515,AUDCAD,5,3.64,0,5,1.0
566515,AUDJPY,12,-55.57000000000001,4,8,0.6666666666666666
566515,AUDNZD,36,-67.45,11,25,0.6944444444444444
566515,AUDUSD,8,-76.33,3,5,0.625
566515,CADJPY,5,-37.519999999999996,3,2,0.4
566515,CHFJPY,1,-7.27,1,0,0.0
566515,EURAUD,6,108.15,1,5,0.8333333333333334
566515,EURCAD,11,-326.86,6,5,0.45454545454545453
566515,EURCHF,14,24.05,5,9,0.6428571428571429
566515,EURGBP,2,-41.25,1,1,0.5
566515,EURJPY,19,67.84,1,18,0.9473684210526315
566515,EURUSD,10,15.89,0,10,1.0
566515,GBPCHF,14,6.410000000000001,7,7,0.5
566515,GBPJPY,22,-83.3,6,16,0.7272727272727273
566515,GBPUSD,17,-439.45,8,9,0.5294117647058824
566515,NZDUSD,14,42.49,3,11,0.7857142857142857
566515,USDCAD,10,-3.2700000000000005,1,9,0.9
566515,USDCHF,15,-41.32,3,12,0.8
566515,USDJPY,13,11.819999999999999,4,9,0.6923076923076923
566515,USDMXN,7,35.14,4,3,0.42857142857142855
566536,EURUSD,283,-299.8,49,234,0.8268551236749117
566544,AUDJPY,1,-2.74,1,0,0.0
566544,AUDUSD,58,-245.64,36,22,0.3793103448275862
566544,CHFJPY,9,-12.080000000000002,3,6,0.6666666666666666
566544,EURCHF,17,-19.630000000000006,7,10,0.5882352941176471
566544,EURGBP,2,-70.45,2,0,0.0
566544,EURJPY,32,-105.64,21,11,0.34375
566544,EURUSD,333,-173.94,152,181,0.5435435435435435
566544,GBPJPY,12,-225.68,10,2,0.16666666666666666
566544,GBPUSD,80,-450.62,43,37,0.4625
566544,USDCAD,80,-377.8,43,37,0.4625
566544,USDCHF,21,-151.32999999999998,13,8,0.38095238095238093
566544,USDJPY,15,26.149999999999995,6,9,0.6
566544,XAGUSD,1,0.0,1,0,0.0
566546,AUDJPY,1,599.16,0,1,1.0
566546,AUDUSD,12,-3900.0,5,7,0.5833333333333334
566546,EURCHF,14,-850.31,6,8,0.5714285714285714
566546,EURGBP,1,31.35,0,1,1.0
566546,EURUSD,150,-426.5,34,116,0.7733333333333333
566546,GBPUSD,45,-729.0,13,32,0.7111111111111111
566546,NZDUSD,2,-5.0,1,1,0.5
566546,USDCHF,28,646.83,8,20,0.7142857142857143
566546,USDJPY,2,31.72,0,2,1.0
566605,AUDJPY,5,-1746.85,4,1,0.2
566605,AUDUSD,91,-3371.33,42,49,0.5384615384615384
566605,CHFJPY,3,-308.69,3,0,0.0
566605,EURAUD,1,557.78,0,1,1.0
566605,EURCHF,56,1528.3,14,42,0.75
566605,EURJPY,100,-1189.27,31,69,0.69
566605,EURUSD,224,-2525.67,109,115,0.5133928571428571
566605,GBPCHF,3,-1104.75,2,1,0.3333333333333333
566605,GBPJPY,8,-1164.6,6,2,0.25
566605,GBPUSD,43,488.65999999999997,29,14,0.32558139534883723
566605,NZDUSD,9,-40.379999999999995,7,2,0.2222222222222222
566605,USDCAD,67,1356.0,20,47,0.7014925373134329
566605,USDCHF,90,-3165.09,44,46,0.5111111111111111
566605,USDJPY,78,-1977.8,34,44,0.5641025641025641
566605,XAGUSD,5,-83.13,3,2,0.4
566605,XAUUSD,1,70.03,0,1,1.0
566659,AUDJPY,6,-12.75,3,3,0.5
566659,AUDUSD,121,-477.82,42,79,0.6528925619834711
566659,EURJPY,25,-369.51,8,17,0.68
566659,EURUSD,202,-660.23,72,130,0.6435643564356436
566659,GBPJPY,18,-107.00999999999999,9,9,0.5
566659,GBPUSD,204,6.200000000000003,57,147,0.7205882352941176
566659,NZDUSD,1,-2.64,1,0,0.0
566659,USDCHF,56,-236.37,26,30,0.5357142857142857
566659,USDJPY,21,-67.39,8,13,0.6190476190476191
566743,AUDJPY,7,-35.59,5,2,0.2857142857142857
566743,AUDUSD,57,-39.4,40,17,0.2982456140350877
566743,EURGBP,23,-40.59,19,4,0.17391304347826086
566743,EURJPY,9,-4.62,5,4,0.4444444444444444
566743,EURUSD,25,-40.8,21,4,0.16
566743,GBPJPY,1,-2.92,1,0,0.0
566743,GBPUSD,18,-16.9,15,3,0.16666666666666666
566743,USDCAD,5,-11.9,4,1,0.2
566743,USDCHF,9,-13.959999999999999,8,1,0.1111111111111111
566743,USDJPY,8,-8.64,6,2,0.25
566743,XAGUSD,337,-2386.1000000000004,145,192,0.56973293768546
566832,AUDNZD,100,-681.49,42,58,0.58
566832,EURUSD,86,-157.65999999999997,30,56,0.6511627906976745
566832,USDCHF,51,230.16,16,35,0.6862745098039216
566934,AUDCAD,1,-117.97,1,0,0.0
566934,AUDJPY,3,-784.5400000000001,2,1,0.3333333333333333
566934,AUDUSD,151,2697.05,28,123,0.8145695364238411
566934,CHFJPY,2,-222.46,2,0,0.0
566934,EURAUD,2,575.66,0,2,1.0
566934,EURCAD,1,0.0,1,0,0.0
566934,EURCHF,90,-13020.89,29,61,0.6777777777777778
566934,EURJPY,163,10057.52,20,143,0.8773006134969326
566934,EURUSD,154,2755.08,15,139,0.9025974025974026
566934,GBPCHF,103,-13182.289999999999,24,79,0.7669902912621359
566934,GBPJPY,120,4289.5599999999995,19,101,0.8416666666666667
566934,GBPUSD,125,2867.18,13,112,0.896
566934,USDCAD,99,1891.51,9,90,0.9090909090909091
566934,USDCHF,137,-17465.1,27,110,0.8029197080291971
566934,USDJPY,182,5795.18,13,169,0.9285714285714286
567030,EURUSD,68,-1019.5,13,55,0.8088235294117647
567030,GBPUSD,5,94.0,1,4,0.8
567030,USDCAD,60,3989.3299999999995,10,50,0.8333333333333334
567030,USDCHF,26,-806.81,6,20,0.7692307692307693
567030,USDJPY,15,699.4399999999999,1,14,0.9333333333333333
567030,XAGUSD,8,-1582.0,4,4,0.5
567030,XAUUSD,27,-2851.1000000000004,8,19,0.7037037037037037
567049,AUDUSD,2,1.8,1,1,0.5
567049,CADJPY,1,8.12,0,1,1.0
567049,EURCAD,1,-0.1,1,0,0.0
567049,EURGBP,1,0.79,0,1,1.0
567049,EURJPY,11,-86.96,5,6,0.5454545454545454
567049,EURUSD,72,8.300000000000002,22,50,0.6944444444444444
567049,GBPUSD,14,32.800000000000004,4,10,0.7142857142857143
567049,NZDUSD,1,0.8,0,1,1.0
567049,USDCAD,1,-5.28,1,0,0.0
567049,USDCHF,6,1.8599999999999994,2,4,0.6666666666666666
567049,USDJPY,19,-6.89,9,10,0.5263157894736842
567071,AUDUSD,101,-173.17,42,59,0.5841584158415841
567071,EURJPY,2,-44.099999999999994,1,1,0.5
567071,EURUSD,332,-190.55,139,193,0.5813253012048193
567071,GBPJPY,1,-20.6,1,0,0.0
567071,GBPUSD,14,-166.05,5,9,0.6428571428571429
567071,NZDUSD,3,15.02,0,3,1.0
567071,USDCHF,5,-257.24,4,1,0.2
567071,USDJPY,2,203.6,0,2,1.0
567071,XAUUSD,1,-1.0,1,0,0.0
567072,AUDUSD,4,-19.0,4,0,0.0
567072,CADJPY,1,-1.35,1,0,0.0
567072,EURAUD,4,-18.39,3,1,0.25
567072,EURCAD,6,-43.84,6,0,0.0
567072,EURCHF,7,-1.2100000000000009,4,3,0.42857142857142855
567072,EURGBP,7,-40.95,7,0,0.0
567072,EURUSD,84,-51.03,55,29,0.34523809523809523
567072,GBPCHF,6,-48.69,5,1,0.16666666666666666
567072,GBPUSD,40,-68.03,35,5,0.125
567072,NZDUSD,6,12.98,3,3,0.5
567072,USDCAD,1,-1.32,1,0,0.0
567072,USDCHF,63,-14.26,39,24,0.38095238095238093
567072,USDJPY,2,-0.050000000000000044,1,1,0.5
567157,EURUSD,1343,-54229.0,489,854,0.6358897989575577
567157,GBPUSD,1,-160.0,1,0,0.0
567164,AUDCAD,1,-2.83,1,0,0.0
567164,AUDJPY,4,-26.68,4,0,0.0
567164,AUDUSD,3,-16.76,2,1,0.3333333333333333
567164,CADJPY,2,-27.76,2,0,0.0
567164,CHFJPY,3,-162.81,3,0,0.0
567164,EURAUD,2,-2.86,2,0,0.0
567164,EURCAD,1,-18.58,1,0,0.0
567164,EURGBP,1,-31.62,1,0,0.0
567164,EURJPY,5,-33.24,2,3,0.6
567164,EURUSD,14,-144.61,7,7,0.5
567164,GBPCHF,1,-7.65,1,0,0.0
567164,GBPJPY,13,157.43,4,9,0.6923076923076923
567164,GBPUSD,8,-50.21,7,1,0.125
567164,NZDUSD,11,6.859999999999999,3,8,0.7272727272727273
567164,USDCAD,4,2.290000000000001,2,2,0.5
567164,USDCHF,14,65.05,4,10,0.7142857142857143
567164,USDJPY,6,9.329999999999998,3,3,0.5
567164,XAGUSD,5,-261.82,2,3,0.6
567164,XAUUSD,2,-394.84,2,0,0.0
567171,AUDUSD,1,15.0,0,1,1.0
567171,EURCHF,3,34.84,2,1,0.3333333333333333
567171,EURJPY,3,76.63,0,3,1.0
567171,EURUSD,183,-22387.5,69,114,0.6229508196721312
567171,GBPUSD,7,100.5,2,5,0.7142857142857143
567171,USDCHF,3,31.11,1,2,0.6666666666666666
567171,USDJPY,7,-11.979999999999999,6,1,0.14285714285714285
567171,XAUUSD,13,-651.0,6,7,0.5384615384615384
567249,AUDUSD,23,75.6,11,12,0.5217391304347826
567249,CADJPY,2,-18.55,2,0,0.0
567249,CHFJPY,1,-4.05,1,0,0.0
567249,EURCAD,1,-39.45,1,0,0.0
567249,EURCHF,7,3.219999999999999,2,5,0.7142857142857143
567249,EURGBP,7,-39.69,5,2,0.2857142857142857
567249,EURUSD,25,446.5,10,15,0.6
567249,GBPCHF,1,1.96,0,1,1.0
567249,GBPUSD,18,1.1000000000000005,9,9,0.5
567249,NZDUSD,2,-2.2,1,1,0.5
567249,USDCAD,21,34.76,11,10,0.47619047619047616
567249,USDCHF,23,-266.86,13,10,0.43478260869565216
567249,USDJPY,10,25.869999999999997,6,4,0.4
567249,XAUUSD,7,37.55,3,4,0.5714285714285714
567282,AUDUSD,3,408.0,1,2,0.6666666666666666
567282,EURCHF,1,0.39,0,1,1.0
567282,EURJPY,4,2.9999999999999996,3,1,0.25
567282,EURUSD,111,170.9,40,71,0.6396396396396397
567282,GBPUSD,83,-382.6000000000001,38,45,0.5421686746987951
567282,USDCAD,6,-317.57,3,3,0.5
567282,USDCHF,6,-87.75,3,3,0.5
567282,USDJPY,6,79.41000000000003,2,4,0.6666666666666666
567365,AUDCAD,5,-17.07,1,4,0.8
567365,AUDJPY,1,-32.44,1,0,0.0
567365,AUDUSD,6,11.14,1,5,0.8333333333333334
567365,CADJPY,1,0.62,0,1,1.0
567365,EURGBP,6,-26.669999999999998,4,2,0.3333333333333333
567365,EURJPY,4,-29.380000000000003,1,3,0.75
567365,EURUSD,3103,-96244.1,593,2510,0.808894618111505
567365,GBPUSD,15,27.919999999999998,0,15,1.0
567365,NZDUSD,4,3.15,0,4,1.0
567365,USDCAD,22,-16.88,3,19,0.8636363636363636
567365,USDCHF,2,1.24,0,2,1.0
567365,USDJPY,34,-352.61,13,21,0.6176470588235294
567365,XAGUSD,107,512.1999999999999,12,95,0.8878504672897196
567365,XAUUSD,15,24.32,0,15,1.0
567376,AUDCAD,1,-0.1,1,0,0.0
567376,AUDJPY,8,-21.04,7,1,0.125
567376,AUDUSD,49,-26.86,30,19,0.3877551020408163
567376,CADJPY,2,-1.98,2,0,0.0
567376,CHFJPY,7,-18.11,6,1,0.14285714285714285
567376,EURAUD,7,-45.61,6,1,0.14285714285714285
567376,EURCAD,6,-15.259999999999998,5,1,0.16666666666666666
567376,EURCHF,17,-41.5,14,3,0.17647058823529413
567376,EURGBP,21,-10.010000000000002,15,6,0.2857142857142857
567376,EURJPY,93,-95.57,52,41,0.44086021505376344
567376,EURUSD,655,-712.25,360,295,0.45038167938931295
567376,GBPCHF,10,-69.02,9,1,0.1
567376,GBPJPY,99,-229.4,54,45,0.45454545454545453
567376,GBPUSD,179,-570.76,96,83,0.46368715083798884
567376,NZDUSD,38,-43.28,22,16,0.42105263157894735
567376,USDCAD,95,-77.94,59,36,0.37894736842105264
567376,USDCHF,45,-7.969999999999999,22,23,0.5111111111111111
567376,USDJPY,73,-20.16,38,35,0.4794520547945205
567376,USDTRY,1,-4.9,1,0,0.0
567376,XAUUSD,4,-7.57,3,1,0.25
567380,USDJPY,358,-2471.56,159,199,0.5558659217877095
567391,EURJPY,10,2.45,2,8,0.8
567391,EURUSD,632,-225.28,166,466,0.7373417721518988
567391,GBPUSD,71,-2.5500000000000016,13,58,0.8169014084507042
567391,USDCHF,5,-1.6400000000000001,3,2,0.4
567391,USDJPY,20,-15.95,11,9,0.45
567391,XAUUSD,19,-82.98,9,10,0.5263157894736842
567454,EURJPY,3,3.19,0,3,1.0
567454,EURUSD,4195,260.22,540,3655,0.8712753277711561
567454,GBPUSD,4,-9.6,3,1,0.25
567454,USDJPY,2,-8.92,2,0,0.0
567514,AUDJPY,19,-41.03,11,8,0.42105263157894735
567514,AUDUSD,76,-10.680000000000003,41,35,0.4605263157894737
567514,CADJPY,1,-8.89,1,0,0.0
567514,EURAUD,44,-48.72,25,19,0.4318181818181818
567514,EURCHF,33,-24.54,15,18,0.5454545454545454
567514,EURJPY,43,-36.86,25,18,0.4186046511627907
567514,EURUSD,61,18.040000000000006,30,31,0.5081967213114754
567514,GBPJPY,28,-12.180000000000001,15,13,0.4642857142857143
567514,GBPUSD,30,-19.28,17,13,0.43333333333333335
567514,USDJPY,60,-78.13,34,26,0.43333333333333335
567514,XAUUSD,1,-8.86,1,0,0.0
567522,AUDUSD,41,-1475.6,16,25,0.6097560975609756
567522,EURAUD,6,-296.84000000000003,2,4,0.6666666666666666
567522,EURUSD,201,-1694.2099999999998,72,129,0.6417910447761194
567522,GBPUSD,24,-1904.5,15,9,0.375
567522,NZDUSD,9,-436.06,5,4,0.4444444444444444
567522,USDJPY,72,-741.51,37,35,0.4861111111111111
567522,XAGUSD,180,-8948.5,74,106,0.5888888888888889
567522,XAUUSD,101,13.340000000000032,26,75,0.7425742574257426
567543,AUDUSD,71,-1086.31,44,27,0.38028169014084506
567543,EURJPY,4,-136.89,3,1,0.25
567543,EURUSD,1188,-9297.46,580,608,0.5117845117845118
567543,GBPUSD,4,60.0,0,4,1.0
567543,USDJPY,645,-11786.79,425,220,0.34108527131782945
567543,USDTRY,1,-40.24,1,0,0.0
567543,XAGUSD,45,-243.8,45,0,0.0
567618,EURCHF,62,-4608.07,34,28,0.45161290322580644
567618,EURGBP,62,-3714.8399999999992,26,36,0.5806451612903226
567618,EURJPY,6,389.89000000000004,1,5,0.8333333333333334
567618,EURUSD,612,-37677.78,317,295,0.4820261437908497
567618,GBPJPY,11,924.99,7,4,0.36363636363636365
567618,GBPUSD,7,-187.10000000000002,5,2,0.2857142857142857
567618,USDCHF,1,-2.83,1,0,0.0
567634,EURCHF,14,57.76000000000001,4,10,0.7142857142857143
567634,EURJPY,1,-0.46,1,0,0.0
567634,EURUSD,1262,-1765.89,332,930,0.7369255150554676
567634,GBPUSD,3,0.48,0,3,1.0
567634,USDCAD,1,0.29,0,1,1.0
567634,USDCHF,24,-496.73,9,15,0.625
567634,USDJPY,117,-199.68,42,75,0.6410256410256411
567693,EURGBP,21,-447.36,9,12,0.5714285714285714
567693,EURJPY,22,-701.91,12,10,0.45454545454545453
567693,EURUSD,9,-299.98,7,2,0.2222222222222222
567693,GBPJPY,14,-362.1399999999999,8,6,0.42857142857142855
567693,USDCHF,21,4650.4800000000005,4,17,0.8095238095238095
567693,USDJPY,24,1758.2600000000002,7,17,0.7083333333333334
567693,XAUUSD,10,1250.1100000000001,5,5,0.5
567702,AUDUSD,24,-38.0,12,12,0.5
567702,CHFJPY,1,-3.63,1,0,0.0
567702,EURCHF,40,-111.02,23,17,0.425
567702,EURGBP,8,-80.85,8,0,0.0
567702,EURJPY,3,26.970000000000002,0,3,1.0
567702,EURUSD,1396,-5702.76,538,858,0.6146131805157593
567702,GBPJPY,1,4.86,0,1,1.0
567702,GBPUSD,52,-142.6,31,21,0.40384615384615385
567702,USDCAD,9,-24.58,6,3,0.3333333333333333
567702,USDCHF,759,-1000.57,342,417,0.549407114624506
567702,USDJPY,38,-314.91,25,13,0.34210526315789475
567707,AUDJPY,14,-30.300000000000004,4,10,0.7142857142857143
567707,AUDUSD,9,-115.42,3,6,0.6666666666666666
567707,CADJPY,6,-50.82,5,1,0.16666666666666666
567707,CHFJPY,14,4.299999999999997,2,12,0.8571428571428571
567707,EURAUD,4,41.309999999999995,0,4,1.0
567707,EURCHF,19,-40.599999999999994,6,13,0.6842105263157895
567707,EURJPY,26,-33.01000000000002,2,24,0.9230769230769231
567707,EURUSD,74,-877.08,25,49,0.6621621621621622
567707,GBPCHF,11,-283.11,5,6,0.5454545454545454
567707,GBPJPY,11,130.46,0,11,1.0
567707,GBPUSD,28,169.18,0,28,1.0
567707,USDCHF,9,-40.32,3,6,0.6666666666666666
567707,USDJPY,12,-132.1,5,7,0.5833333333333334
567844,AUDNZDr,1,-0.97,1,0,0.0
567844,AUDUSD,39,-164.29999999999998,17,22,0.5641025641025641
567844,AUDUSDr,11,-183.0,6,5,0.45454545454545453
567844,EURGBPr,1,-5.5,1,0,0.0
567844,EURJPY,67,-1811.32,26,41,0.6119402985074627
567844,EURJPYr,8,-238.07,5,3,0.375
567844,EURUSD,189,-642.7599999999999,75,114,0.6031746031746031
567844,EURUSDr,74,-507.9,44,30,0.40540540540540543
567844,GBPJPY,5,-980.3,4,1,0.2
567844,GBPUSD,137,-3183.29,60,77,0.5620437956204379
567844,GBPUSDr,57,-331.5,28,29,0.5087719298245614
567844,USDCHFr,11,-23.97,7,4,0.36363636363636365
567844,USDJPYr,6,-38.39,2,4,0.6666666666666666
567844,XAGUSD,1,-5.9,1,0,0.0
567844,XAGUSDr,11,-191.5,5,6,0.5454545454545454
567844,XAUUSD,1,14.7,0,1,1.0
567844,XAUUSDr,6,-478.24,3,3,0.5
568037,AUDUSD,152,-144.41000000000005,78,74,0.4868421052631579
568037,EURCHF,27,-229.85,10,17,0.6296296296296297
568037,EURUSD,244,-475.25,117,127,0.5204918032786885
568037,GBPUSD,15,-352.4,10,5,0.3333333333333333
568037,USDCHF,1,-57.01,1,0,0.0
568037,USDJPY,18,-126.36999999999999,11,7,0.3888888888888889
568038,AUDJPY,8,279.82,5,3,0.375
568038,AUDNZD,4,880.94,1,3,0.75
568038,AUDUSD,85,-27361.35,45,40,0.47058823529411764
568038,EURAUD,4,82.90000000000003,1,3,0.75
568038,EURCHF,23,-4390.83,13,10,0.43478260869565216
568038,EURGBP,2,-202.69,1,1,0.5
568038,EURJPY,15,834.9000000000001,7,8,0.5333333333333333
568038,EURUSD,82,5122.5,41,41,0.5
568038,GBPJPY,94,22576.09,32,62,0.6595744680851063
568038,GBPUSD,57,-4537.25,35,22,0.38596491228070173
568038,NZDUSD,4,-396.5,2,2,0.5
568038,USDCAD,128,2627.7200000000007,48,80,0.625
568038,USDCHF,84,-39945.26,36,48,0.5714285714285714
568038,USDJPY,82,3252.2400000000007,31,51,0.6219512195121951
568108,EURJPY,804,-548.15,433,371,0.4614427860696517
568108,EURUSD,37,42.589999999999996,11,26,0.7027027027027027
568108,USDJPY,2,-2.98,1,1,0.5
568174,EURCHF,1,36.26,0,1,1.0
568174,EURGBP,3,-76.57000000000001,3,0,0.0
568174,EURUSD,110,-286.13,24,86,0.7818181818181819
568174,GBPJPY,1,27.98,0,1,1.0
568174,GBPUSD,2,278.5,0,2,1.0
568174,USDCHF,5,310.22,0,5,1.0
568193,AUDUSD,15,-15.480000000000002,2,13,0.8666666666666667
568193,EURUSD,5,6.01,0,5,1.0
568193,GBPJPY,6,5.24,0,6,1.0
568193,GBPUSD,406,103.46999999999998,25,381,0.9384236453201971
568197,AUDCAD,2,13.67,0,2,1.0
568197,AUDJPY,8,45.559999999999995,3,5,0.625
568197,AUDUSD,15,251.4,4,11,0.7333333333333333
568197,CADJPY,4,-141.31,4,0,0.0
568197,EURAUD,1,-72.96,1,0,0.0
568197,EURCAD,2,-75.27,2,0,0.0
568197,EURCHF,1,19.55,0,1,1.0
568197,EURJPY,13,-307.31,6,7,0.5384615384615384
568197,EURUSD,11,-495.5,8,3,0.2727272727272727
568197,GBPCHF,1,21.42,0,1,1.0
568197,GBPJPY,7,-29.149999999999995,4,3,0.42857142857142855
568197,GBPUSD,7,-181.9,3,4,0.5714285714285714
568197,NZDUSD,20,-384.40000000000003,10,10,0.5
568197,USDCAD,11,-138.9,7,4,0.36363636363636365
568197,USDCHF,10,-284.52,7,3,0.3
568197,USDJPY,5,31.439999999999998,1,4,0.8
568197,XAGUSD,8,-62.7,4,4,0.5
568197,XAUUSD,5,-78.59,3,2,0.4
568199,AUDCAD,3,4.2,0,3,1.0
568199,AUDUSD,24,40.42,1,23,0.9583333333333334
568199,GBPUSD,29,3.1500000000000017,4,25,0.8620689655172413
568199,USDCAD,250,393.39,14,236,0.944
568237,AUDCAD,4,-171.19,4,0,0.0
568237,AUDJPY,14,-594.36,9,5,0.35714285714285715
568237,AUDNZD,5,-49.120000000000005,4,1,0.2
568237,AUDUSD,159,-764.37,63,96,0.6037735849056604
568237,CADJPY,7,33.480000000000004,2,5,0.7142857142857143
568237,EURAUD,10,-114.29,5,5,0.5
568237,EURCAD,2,40.36,0,2,1.0
568237,EURCHF,46,123.45999999999998,18,28,0.6086956521739131
568237,EURGBP,11,36.699999999999996,4,7,0.6363636363636364
568237,EURJPY,63,-0.44999999999999574,21,42,0.6666666666666666
568237,EURUSD,232,-534.71,93,139,0.5991379310344828
568237,GBPCHF,14,-236.88000000000002,5,9,0.6428571428571429
568237,GBPJPY,6,44.21,1,5,0.8333333333333334
568237,GBPUSD,113,-1888.31,40,73,0.6460176991150443
568237,NZDUSD,3,-10.79,2,1,0.3333333333333333
568237,USDCAD,101,-1246.41,46,55,0.5445544554455446
568237,USDCHF,111,273.63,36,75,0.6756756756756757
568237,USDJPY,327,-1371.26,156,171,0.5229357798165137
568237,XAGUSD,29,63.94,11,18,0.6206896551724138
568237,XAUUSD,40,912.62,3,37,0.925
568239,AUDNZD,3,-84.75999999999999,3,0,0.0
568239,AUDUSD,79,-4668.9800000000005,28,51,0.6455696202531646
568239,EURCAD,12,-617.24,7,5,0.4166666666666667
568239,EURUSD,305,-3849.8399999999997,107,198,0.6491803278688525
568239,GBPJPY,7,-188.19999999999993,4,3,0.42857142857142855
568239,GBPUSD,93,1551.75,30,63,0.6774193548387096
568239,NZDUSD,3,119.0,0,3,1.0
568239,USDCAD,126,1602.72,33,93,0.7380952380952381
568239,USDCHF,2,-234.57999999999998,1,1,0.5
568239,USDJPY,30,709.01,10,20,0.6666666666666666
568239,XAUUSD,250,2637.5000000000005,67,183,0.732
568240,AUDCAD,3,4.6,0,3,1.0
568240,AUDUSD,31,70.02,2,29,0.9354838709677419
568240,GBPUSD,38,-135.19,9,29,0.7631578947368421
568240,USDCAD,182,443.47,11,171,0.9395604395604396
568264,AUDUSD,1,1.4,0,1,1.0
568264,EURUSD,114,29.8,19,95,0.8333333333333334
568264,GBPUSD,15,11.5,2,13,0.8666666666666667
568264,USDCAD,5,4.2,2,3,0.6
568300,EURCHF,1,2.06,0,1,1.0
568300,EURJPY,10,-439.29,7,3,0.3
568300,EURUSD,1749,-22567.32,275,1474,0.8427672955974843
568300,GBPUSD,19,-226.34,6,13,0.6842105263157895
568300,USDJPY,1,0.0,1,0,0.0
568347,AUDJPY,8,168.11,2,6,0.75
568347,AUDUSD,71,-274.55999999999995,34,37,0.5211267605633803
568347,CADJPY,2,5.8999999999999995,0,2,1.0
568347,CHFJPY,1,-38.49,1,0,0.0
568347,EURAUD,1,0.76,0,1,1.0
568347,EURCHF,1,1.23,0,1,1.0
568347,EURUSD,21,-1867.51,7,14,0.6666666666666666
568347,GBPJPY,43,-793.4300000000001,12,31,0.7209302325581395
568347,GBPUSD,9,-165.8,4,5,0.5555555555555556
568347,NZDUSD,4,28.759999999999998,1,3,0.75
568347,USDCAD,14,-317.23999999999995,5,9,0.6428571428571429
568347,USDCHF,4,-334.72,4,0,0.0
568347,USDJPY,53,-409.37999999999994,22,31,0.5849056603773585
568366,AUDCAD,4,4.99,0,4,1.0
568366,AUDUSD,33,105.43,3,30,0.9090909090909091
568366,GBPUSD,46,26.910000000000004,8,38,0.8260869565217391
568366,USDCAD,175,525.27,7,168,0.96
568408,EURUSD,287,-75.10000000000001,90,197,0.686411149825784
568439,EURUSD,394,-1144.1499999999999,74,320,0.8121827411167513
568439,USDJPY,1,-3.07,1,0,0.0
568461,AUDCAD,3,-13.94,3,0,0.0
568461,AUDJPY,9,-17.91,7,2,0.2222222222222222
568461,AUDNZD,1,0.72,0,1,1.0
568461,AUDUSD,29,-4.279999999999999,12,17,0.5862068965517241
568461,EURAUD,3,4.27,1,2,0.6666666666666666
568461,EURCAD,25,-37.69,13,12,0.48
568461,EURGBP,21,-20.12,9,12,0.5714285714285714
568461,EURJPY,2,-7.18,2,0,0.0
568461,EURUSD,60,-26.17,28,32,0.5333333333333333
568461,GBPCHF,11,-34.92,7,4,0.36363636363636365
568461,GBPJPY,7,-23.270000000000003,5,2,0.2857142857142857
568461,GBPUSD,33,-16.57,13,20,0.6060606060606061
568461,NZDUSD,20,-10.620000000000001,11,9,0.45
568461,USDCAD,27,-14.680000000000001,13,14,0.5185185185185185
568461,USDCHF,26,22.900000000000002,13,13,0.5
568461,USDJPY,31,10.46,9,22,0.7096774193548387
568507,AUDUSD,5,-9.7,5,0,0.0
568507,EURUSD,513,-176.20000000000002,241,272,0.530214424951267
568507,GBPUSD,155,-213.6,75,80,0.5161290322580645
568507,USDCHF,107,-34.32,45,62,0.5794392523364486
568507,USDJPY,112,-29.6,45,67,0.5982142857142857
568546,CADJPY,299,-73624.99,59,240,0.802675585284281
568546,USDCHF,1,4.49,0,1,1.0
568546,USDJPY,609,-92321.05,110,499,0.819376026272578
568572,EURGBP,11,5.15,2,9,0.8181818181818182
568572,EURUSD,3592,-3527.6600000000003,1714,1878,0.5228285077951003
568572,USDJPY,5,-0.5999999999999999,3,2,0.4
568625,AUDUSD,16,679.0,6,10,0.625
568625,EURJPY,1,24.19,0,1,1.0
568625,EURUSD,61,-17052.6,22,39,0.639344262295082
568625,GBPJPY,2,323.1600000000001,1,1,0.5
568625,GBPUSD,8,355.0,4,4,0.5
568625,USDJPY,2,-1856.4,2,0,0.0
568625,XAUUSD,92,-33720.65,31,61,0.6630434782608695
568630,AUDNZD,1,0.0,1,0,0.0
568630,AUDUSD,2,33.6,1,1,0.5
568630,EURUSD,23,1073.3999999999999,8,15,0.6521739130434783
568630,GBPUSD,27,-1911.8300000000002,14,13,0.48148148148148145
568630,XAUUSD,907,-66884.62,284,623,0.6868798235942668
568656,CHFJPY,3,-66.78,2,1,0.3333333333333333
568656,EURCHF,4,-574.74,4,0,0.0
568656,EURUSD,94,-26.44000000000007,45,49,0.5212765957446809
568656,GBPCHF,2,-327.27000000000004,2,0,0.0
568656,GBPUSD,52,-334.42,30,22,0.4230769230769231
568656,NZDUSD,5,-239.0,4,1,0.2
568656,USDCAD,5,25.5,1,4,0.8
568656,USDCHF,18,-710.87,12,6,0.3333333333333333
568656,USDJPY,2,-39.809999999999995,1,1,0.5
568656,USDTRY,1,0.3,0,1,1.0
568656,XAUUSD,11,195.55,5,6,0.5454545454545454
568762,AUDUSD,4,1.5500000000000003,1,3,0.75
568762,CHFJPY,3,-4.1899999999999995,2,1,0.3333333333333333
568762,EURCHF,2,-6.69,2,0,0.0
568762,EURGBP,1,-7.77,1,0,0.0
568762,EURJPY,2,-5.210000000000001,1,1,0.5
568762,EURUSD,62,-33.56999999999999,21,41,0.6612903225806451
568762,GBPCHF,1,6.61,0,1,1.0
568762,GBPJPY,2,2.2800000000000002,0,2,1.0
568762,GBPUSD,20,-61.89,12,8,0.4
568762,USDCAD,3,1.98,1,2,0.6666666666666666
568762,USDCHF,3,-35.98,1,2,0.6666666666666666
568762,USDJPY,6,-2.9800000000000004,2,4,0.6666666666666666
568780,AUDCAD,3,1.49,0,3,1.0
568780,AUDJPY,1,1.39,0,1,1.0
568780,AUDNZD,1,-0.99,1,0,0.0
568780,AUDUSD,7,236.34,0,7,1.0
568780,CADJPY,2,0.7899999999999999,0,2,1.0
568780,CHFJPY,3,0.47,0,3,1.0
568780,EURAUD,3,1.09,0,3,1.0
568780,EURCAD,1,0.49,0,1,1.0
568780,EURCHF,3,-232.91,2,1,0.3333333333333333
568780,EURGBP,6,5.239999999999999,1,5,0.8333333333333334
568780,EURJPY,3,1.29,0,3,1.0
568780,EURUSD,13,9.9,0,13,1.0
568780,GBPCHF,11,24.01,1,10,0.9090909090909091
568780,GBPJPY,6,-7.2,2,4,0.6666666666666666
568780,GBPUSD,10,15.1,2,8,0.8
568780,NZDUSD,5,2.27,1,4,0.8
568780,USDCAD,7,1.8800000000000001,1,6,0.8571428571428571
568780,USDCHF,8,16.83,1,7,0.875
568780,USDJPY,4,6.87,1,3,0.75
568780,USDTRY,1,0.33,0,1,1.0
568780,XAGUSD,2,-9.8,2,0,0.0
568805,AUDUSD,18,1246.8400000000001,4,14,0.7777777777777778
568805,EURUSD,131,-1151.29,49,82,0.6259541984732825
568805,GBPUSD,2,99.95,0,2,1.0
568805,USDJPY,1,26.54,0,1,1.0
568808,AUDJPY,10,1678.3,0,10,1.0
568808,AUDUSD,33,-430.99999999999994,2,31,0.9393939393939394
568808,CADJPY,13,1442.9299999999998,2,11,0.8461538461538461
568808,CHFJPY,14,877.4200000000001,1,13,0.9285714285714286
568808,EURAUD,2,105.06,0,2,1.0
568808,EURCHF,9,627.49,0,9,1.0
568808,EURGBP,8,633.24,0,8,1.0
568808,EURJPY,25,2384.47,0,25,1.0
568808,EURUSD,25,1586.0,0,25,1.0
568808,GBPCHF,69,-7634.71,7,62,0.8985507246376812
568808,GBPJPY,21,2089.17,0,21,1.0
568808,GBPUSD,19,949.8,2,17,0.8947368421052632
568808,USDCAD,4,211.15,0,4,1.0
568808,USDCHF,60,-1812.2000000000003,2,58,0.9666666666666667
568808,USDJPY,1,43.6,0,1,1.0
569167,AUDUSD,2,11.5,0,2,1.0
569167,EURCHF,1,1.19,0,1,1.0
569167,EURGBP,7,-12.66,6,1,0.14285714285714285
569167,EURJPY,1,17.69,0,1,1.0
569167,EURUSD,57,54.99,37,20,0.3508771929824561
569167,GBPUSD,45,-44.21,31,14,0.3111111111111111
569167,NZDUSD,1,0.3,0,1,1.0
569167,USDCHF,39,-5.760000000000001,25,14,0.358974358974359
569167,USDJPY,39,12.88,23,16,0.41025641025641024
569167,XAUUSD,8,-17.919999999999998,6,2,0.25
569247,AUDUSD,31,-2.26,16,15,0.4838709677419355
569247,CADJPY,1,-4.66,1,0,0.0
569247,EURAUD,5,3.740000000000001,2,3,0.6
569247,EURCHF,2,-1.7300000000000002,1,1,0.5
569247,EURGBP,2,-6.6000000000000005,1,1,0.5
569247,EURJPY,17,-28.71,11,6,0.35294117647058826
569247,EURUSD,162,-39.13,89,73,0.4506172839506173
569247,GBPCHF,23,-11.79,10,13,0.5652173913043478
569247,GBPJPY,14,12.319999999999999,6,8,0.5714285714285714
569247,GBPUSD,293,-259.95,178,115,0.3924914675767918
569247,NZDUSD,2,-7.38,2,0,0.0
569247,USDCAD,15,-14.16,9,6,0.4
569247,USDCHF,50,-31.6,25,25,0.5
569247,USDJPY,35,-39.24,18,17,0.4857142857142857
569249,AUDUSD,3,3.0,1,2,0.6666666666666666
569249,EURJPY,23,-62.02,12,11,0.4782608695652174
569249,EURUSD,1055,-1785.94,442,613,0.581042654028436
569249,GBPJPY,1,-7.02,1,0,0.0
569249,GBPUSD,27,-182.69,16,11,0.4074074074074074
569249,USDJPY,1,-1.62,1,0,0.0
569305,EURUSD,472,-423.08,181,291,0.6165254237288136
569412,AUDCAD,3,4.76,0,3,1.0
569412,AUDJPY,1,-0.95,1,0,0.0
569412,AUDUSD,30,-291.4,16,14,0.4666666666666667
569412,CHFJPY,2,-64.46000000000001,2,0,0.0
569412,EURCAD,5,-3.1599999999999966,2,3,0.6
569412,EURCHF,21,120.56000000000002,9,12,0.5714285714285714
569412,EURGBP,3,-23.700000000000003,2,1,0.3333333333333333
569412,EURJPY,16,42.83000000000003,8,8,0.5
569412,EURUSD,469,-1762.6499999999999,223,246,0.5245202558635395
569412,GBPCHF,15,61.98000000000002,8,7,0.4666666666666667
569412,GBPJPY,6,58.75,1,5,0.8333333333333334
569412,GBPUSD,32,282.6,11,21,0.65625
569412,NZDUSD,3,20.3,1,2,0.6666666666666666
569412,USDCAD,1,10.02,0,1,1.0
569412,USDCHF,28,21.999999999999986,14,14,0.5
569412,USDJPY,11,-56.82,8,3,0.2727272727272727
569422,AUDUSD,5,-450.0,2,3,0.6
569422,EURJPY,10,2631.75,4,6,0.6
569422,EURUSD,237,-17066.0,124,113,0.4767932489451477
569422,GBPUSD,15,925.0,6,9,0.6
569422,USDCAD,1,-963.28,1,0,0.0
569422,USDJPY,4,-131.07999999999998,2,2,0.5
569466,CHFJPY,138,152.34,14,124,0.8985507246376812
569466,EURUSD,908,-2376.4900000000002,88,820,0.9030837004405287
569466,USDCHF,2,4.38,1,1,0.5
569466,XAGUSD,139,-2919.8,22,117,0.841726618705036
569605,AUDUSD,38,-764.79,23,15,0.39473684210526316
569605,EURUSD,191,746.9,63,128,0.6701570680628273
569605,GBPUSD,5,-29.0,3,2,0.4
569622,AUDCAD,1,4.6,0,1,1.0
569622,AUDUSD,22,175.57,0,22,1.0
569622,GBPUSD,68,-199.8,11,57,0.8382352941176471
569622,USDCAD,126,560.95,11,115,0.9126984126984127
569622,XAGUSD,11,35.43,1,10,0.9090909090909091
569710,XAGUSD,689,-3992.08,288,401,0.5820029027576198
569710,XAUUSD,4,-2.34,2,2,0.5
569742,AUDUSD,2,-5.32,2,0,0.0
569742,EURJPY,1,3.3,0,1,1.0
569742,EURUSD,65,-187.9,28,37,0.5692307692307692
569742,GBPJPY,1,-12.01,1,0,0.0
569742,GBPUSD,33,-24.979999999999997,14,19,0.5757575757575758
569742,USDCHF,1,0.21,0,1,1.0
569789,AUDUSD,26,78.4,1,25,0.9615384615384616
569789,GBPUSD,30,-181.92000000000002,7,23,0.7666666666666667
569789,USDCAD,111,1538.98,8,103,0.9279279279279279
569789,XAGUSD,27,67.56,7,20,0.7407407407407407
569879,AUDUSD,18,-2.269999999999998,3,15,0.8333333333333334
569879,EURJPY,2,1.58,0,2,1.0
569879,EURUSD,63,-427.78000000000003,7,56,0.8888888888888888
569879,GBPJPY,2,1.03,0,2,1.0
569879,GBPUSD,39,19.88,8,31,0.7948717948717948
569879,USDCHF,18,69.09,5,13,0.7222222222222222
569879,USDJPY,15,-17.380000000000003,2,13,0.8666666666666667
569933,AUDUSD,213,-148.14000000000001,109,104,0.48826291079812206
569933,EURCHF,85,-84.46,56,29,0.3411764705882353
569933,EURUSD,23,53.05,4,19,0.8260869565217391
569933,GBPUSD,165,-104.03999999999999,67,98,0.593939393939394
569933,USDCAD,227,-122.02999999999999,115,112,0.4933920704845815
569933,USDCHF,24,-70.9,20,4,0.16666666666666666
569933,USDJPY,23,-56.62,18,5,0.21739130434782608
569933,USDTRY,165,-212.70000000000002,104,61,0.3696969696969697
569933,XAGUSD,749,-1379.29,477,272,0.36315086782376504
570010,EURUSD,1039,-2350.6,215,824,0.793070259865255
570020,AUDUSD,2,-2.3400000000000003,1,1,0.5
570020,EURGBP,1,0.83,0,1,1.0
570020,EURUSD,174,-474.85,49,125,0.7183908045977011
570020,GBPUSD,33,43.61,5,28,0.8484848484848485
570030,AUDUSD,12,-13777.0,4,8,0.6666666666666666
570030,EURUSD,1,-35.0,1,0,0.0
570030,XAUUSD,411,-5348.84,57,354,0.8613138686131386
570093,AUDUSD,318,-1673.4099999999999,101,217,0.6823899371069182
570093,EURGBP,1,-39.68,1,0,0.0
570093,EURJPY,3,-186.95999999999998,3,0,0.0
570093,EURUSD,392,1110.1100000000001,105,287,0.7321428571428571
570093,GBPJPY,3,2.6000000000000014,2,1,0.3333333333333333
570093,USDCAD,253,-130.5,74,179,0.7075098814229249
570093,USDCHF,1,16.0,0,1,1.0
570093,USDJPY,16,42.79,5,11,0.6875
570093,USDTRY,1,-133.11,1,0,0.0
570093,XAGUSD,3,-1123.0,2,1,0.3333333333333333
570093,XAUUSD,140,-3159.21,57,83,0.5928571428571429
570109,EURUSD,1758,-4660.89,515,1243,0.7070534698521047
570109,GBPUSD,2,-6.46,2,0,0.0
570109,USDJPY,4,-29.440000000000005,2,2,0.5
570198,EURUSD,779,-8890.49,319,460,0.5905006418485238
570198,NZDUSD,4,15.33,1,3,0.75
570198,USDJPY,3,-15.41,2,1,0.3333333333333333
570198,USDTRY,5,-1.82,3,2,0.4
570198,XAGUSD,11,-127.13,6,5,0.45454545454545453
570198,XAUUSD,16,-32.06,9,7,0.4375
570244,AUDUSD,46,-45.05,8,38,0.8260869565217391
570244,GBPUSD,56,79.30999999999999,4,52,0.9285714285714286
570244,USDCAD,199,2906.45,16,183,0.9195979899497487
570244,XAGUSD,33,64.53999999999999,4,29,0.8787878787878788
570248,EURUSD,482,-1599.9999999999998,113,369,0.7655601659751037
570253,AUDUSD,8,15.68,2,6,0.75
570253,EURGBP,7,-66.47,6,1,0.14285714285714285
570253,EURJPY,10,20.1,3,7,0.7
570253,EURUSD,633,-567.19,316,317,0.5007898894154819
570253,GBPUSD,33,80.12,16,17,0.5151515151515151
570253,NZDUSD,12,20.169999999999995,4,8,0.6666666666666666
570253,USDCHF,4,2.97,0,4,1.0
570253,USDJPY,7,-13.569999999999999,6,1,0.14285714285714285
570253,USDMXN,10,2.91,7,3,0.3
570253,XAUUSD,2,1.61,0,2,1.0
570406,AUDCAD,18,-814.33,16,2,0.1111111111111111
570406,AUDJPY,2,-100.38000000000001,2,0,0.0
570406,AUDNZD,6,-273.53999999999996,4,2,0.3333333333333333
570406,AUDUSD,6,-368.55,5,1,0.16666666666666666
570406,CADJPY,3,-219.57,2,1,0.3333333333333333
570406,EURAUD,6,-247.78,5,1,0.16666666666666666
570406,EURCAD,3,-30.22,3,0,0.0
570406,EURCHF,16,1308.88,6,10,0.625
570406,EURGBP,17,90.08000000000003,13,4,0.23529411764705882
570406,EURJPY,30,-1066.72,22,8,0.26666666666666666
570406,EURUSD,284,-2367.3199999999997,188,96,0.3380281690140845
570406,GBPCHF,10,-388.33,8,2,0.2
570406,GBPJPY,11,139.48999999999998,8,3,0.2727272727272727
570406,GBPUSD,214,-2199.58,146,68,0.3177570093457944
570406,NZDUSD,5,23.0,3,2,0.4
570406,USDCAD,9,-225.41,8,1,0.1111111111111111
570406,USDCHF,60,-1908.4899999999998,34,26,0.43333333333333335
570406,USDJPY,36,-513.89,24,12,0.3333333333333333
570420,AUDJPY,1,12.72,0,1,1.0
570420,EURCHF,2,5.59,0,2,1.0
570420,EURGBP,10,-181.86000000000004,4,6,0.6
570420,EURUSD,137,1101.6200000000001,46,91,0.6642335766423357
570420,GBPJPY,1,0.12,0,1,1.0
570420,GBPUSD,148,-1192.4799999999998,59,89,0.6013513513513513
570420,NZDUSD,1,-87.0,1,0,0.0
570420,USDCAD,2,13.67,0,2,1.0
570420,USDJPY,23,-133.72,11,12,0.5217391304347826
570420,USDTRY,11,189.79,4,7,0.6363636363636364
570420,XAGUSD,25,-1363.2,11,14,0.56
570420,XAUUSD,50,-543.5300000000001,20,30,0.6
570450,EURUSD,165,-714.85,64,101,0.6121212121212121
570450,GBPUSD,6,-2.68,3,3,0.5
570450,USDCAD,3,0.54,1,2,0.6666666666666666
570450,USDCHF,2,0.53,0,2,1.0
570450,USDJPY,1,-0.64,1,0,0.0
570457,USDJPY,113,55.82000000000004,32,81,0.7168141592920354
570661,AUDCAD,12,525.89,2,10,0.8333333333333334
570661,AUDJPY,1,-380.37,1,0,0.0
570661,AUDUSD,6,-2690.0,4,2,0.3333333333333333
570661,CADJPY,7,182.43999999999994,1,6,0.8571428571428571
570661,CHFJPY,2,-985.11,2,0,0.0
570661,EURAUD,8,804.52,2,6,0.75
570661,EURCAD,7,-808.6500000000001,2,5,0.7142857142857143
570661,EURCHF,2,209.15000000000003,1,1,0.5
570661,EURGBP,9,1387.87,2,7,0.7777777777777778
570661,EURJPY,29,-5262.01,13,16,0.5517241379310345
570661,EURUSD,43,-1711.3600000000001,19,24,0.5581395348837209
570661,GBPCHF,1,477.81,0,1,1.0
570661,GBPJPY,5,865.92,1,4,0.8
570661,GBPUSD,13,477.5,4,9,0.6923076923076923
570661,NZDUSD,8,-650.3,3,5,0.625
570661,USDCAD,17,151.87999999999988,5,12,0.7058823529411765
570661,USDCHF,8,-268.74,5,3,0.375
570661,USDJPY,13,-2258.95,8,5,0.38461538461538464
570661,XAGUSD,12,5397.5,0,12,1.0
570661,XAUUSD,8,2787.0,0,8,1.0
570668,AUDCAD,2,-689.31,1,1,0.5
570668,AUDJPY,2,32.64,0,2,1.0
570668,AUDUSD,2,126.5,0,2,1.0
570668,CHFJPY,2,25.990000000000002,1,1,0.5
570668,EURCAD,1,1115.57,0,1,1.0
570668,EURCHF,132,1041.7299999999996,53,79,0.5984848484848485
570668,EURGBP,1,-1111.89,1,0,0.0
570668,EURJPY,5,-2288.73,3,2,0.4
570668,EURUSD,129,-9406.95,56,73,0.5658914728682171
570668,GBPUSD,1,1.95,0,1,1.0
570668,USDCAD,7,446.16,2,5,0.7142857142857143
570668,USDCHF,12,-1086.19,7,5,0.4166666666666667
570668,USDJPY,8,-1142.7,7,1,0.125
570668,USDMXN,9,-528.13,4,5,0.5555555555555556
570668,XAGUSD,2,12.5,0,2,1.0
570668,XAUUSD,3,18.15,0,3,1.0
570763,EURAUD,4,3.35,0,4,1.0
570763,EURCHF,47,-502.03000000000003,19,28,0.5957446808510638
570763,EURGBP,8,-26.47,4,4,0.5
570763,EURJPY,13,-267.59,3,10,0.7692307692307693
570763,EURUSD,482,-2497.66,107,375,0.7780082987551867
570763,GBPJPY,11,26.240000000000002,2,9,0.8181818181818182
570763,GBPUSD,3,-67.6,2,1,0.3333333333333333
570763,NZDUSD,1,-1.25,1,0,0.0
570763,USDCHF,7,-137.04,3,4,0.5714285714285714
570763,USDJPY,44,-270.7,9,35,0.7954545454545454
570939,USDJPY,114,-16714.37,50,64,0.5614035087719298
570943,EURUSD,148,-21.999999999999996,54,94,0.6351351351351351
570943,USDCAD,5,34.019999999999996,1,4,0.8
571121,AUDNZD,1,21.5,0,1,1.0
571121,AUDUSD,26,-207.34,17,9,0.34615384615384615
571121,EURJPY,37,-293.36,19,18,0.4864864864864865
571121,EURUSD,175,-388.34,75,100,0.5714285714285714
571121,GBPJPY,2,3.460000000000001,1,1,0.5
571121,GBPUSD,9,1.42,3,6,0.6666666666666666
571121,NZDUSD,2,-2.9400000000000013,1,1,0.5
571121,USDCAD,1,54.8,0,1,1.0
571121,USDCHF,2,2.8100000000000005,1,1,0.5
571121,USDJPY,7,-90.27000000000001,4,3,0.42857142857142855
571121,XAGUSD,9,-58.22,3,6,0.6666666666666666
571129,AUDJPY,124,277.85,3,121,0.9758064516129032
571129,AUDUSD,173,-19.979999999999997,12,161,0.930635838150289
571129,EURAUD,136,-259.39,11,125,0.9191176470588235
571129,EURCAD,1,1.55,0,1,1.0
571129,EURGBP,6,7.42,0,6,1.0
571129,EURJPY,218,-1300.97,13,205,0.9403669724770642
571129,EURUSD,173,415.59,3,170,0.9826589595375722
571129,GBPJPY,106,-182.39999999999998,6,100,0.9433962264150944
571129,GBPUSD,77,370.76,2,75,0.974025974025974
571129,NZDUSD,12,16.87,0,12,1.0
571129,USDJPY,68,-439.92,11,57,0.8382352941176471
571129,XAGUSD,2,5.0,0,2,1.0
571129,XAUUSD,23,-216.80999999999997,5,18,0.782608695652174
571140,AUDJPY,27,-83.50000000000001,15,12,0.4444444444444444
571140,AUDNZD,5,-6.35,4,1,0.2
571140,EURAUD,6,-16.560000000000002,2,4,0.6666666666666666
571140,EURCAD,4,-52.73,3,1,0.25
571140,EURGBP,7,-29.71,5,2,0.2857142857142857
571140,GBPUSD,19,-37.17,17,2,0.10526315789473684
571140,USDCAD,1,1.59,0,1,1.0
571140,USDCHF,25,6.720000000000002,10,15,0.6
571140,XAUUSD,107,-277.03,46,61,0.5700934579439252
571216,AUDUSD,4,151.0,0,4,1.0
571216,EURUSD,539,-3151.48,267,272,0.5046382189239332
571216,GBPUSD,23,-33.80000000000004,8,15,0.6521739130434783
571216,USDCAD,3,-50.2,3,0,0.0
571216,USDCHF,8,-605.99,6,2,0.25
571216,USDJPY,3,-247.93,2,1,0.3333333333333333
571262,AUDJPY,4,-17.41,4,0,0.0
571262,AUDUSD,46,67.81,29,17,0.3695652173913043
571262,EURGBP,20,-36.220000000000006,10,10,0.5
571262,EURJPY,8,-10.66,5,3,0.375
571262,EURUSD,69,2.1800000000000024,37,32,0.463768115942029
571262,GBPJPY,50,-185.51,26,24,0.48
571262,GBPUSD,143,-174.14,98,45,0.3146853146853147
571262,NZDUSD,18,-13.860000000000001,8,10,0.5555555555555556
571262,USDCAD,14,-5.87,8,6,0.42857142857142855
571262,USDCHF,6,-14.51,5,1,0.16666666666666666
571262,USDJPY,10,-22.830000000000002,6,4,0.4
571356,AUDUSD,245,-7603.76,89,156,0.636734693877551
571356,EURUSD,6,-1935.0,4,2,0.3333333333333333
571356,GBPUSD,14,800.22,7,7,0.5
571356,USDCAD,8,-323.59000000000003,5,3,0.375
571356,USDCHF,41,3384.05,12,29,0.7073170731707317
571356,USDJPY,43,1642.66,19,24,0.5581395348837209
571356,XAGUSD,1,100.0,0,1,1.0
571356,XAUUSD,10,-583.97,8,2,0.2
571368,AUDUSD,5,11.02,0,5,1.0
571368,EURCHF,7,138.67000000000002,0,7,1.0
571368,EURGBP,1,1.35,0,1,1.0
571368,EURJPY,2,5.359999999999999,0,2,1.0
571368,EURUSD,36,-1882.79,17,19,0.5277777777777778
571368,GBPJPY,1,1.29,0,1,1.0
571368,GBPUSD,54,-557.6700000000001,25,29,0.5370370370370371
571368,NZDUSD,2,8.39,0,2,1.0
571368,USDCAD,2,-1.5000000000000002,1,1,0.5
571368,USDCHF,7,-232.23000000000002,1,6,0.8571428571428571
571368,USDJPY,6,29.0,0,6,1.0
571399,AUDJPY,48,221.84,4,44,0.9166666666666666
571399,AUDUSD,18,119.49,1,17,0.9444444444444444
571399,EURAUD,1,-3.85,1,0,0.0
571399,EURGBP,1,4.09,0,1,1.0
571399,EURJPY,14,-386.32,1,13,0.9285714285714286
571399,EURUSD,30,418.06,1,29,0.9666666666666667
571399,GBPJPY,13,66.03,1,12,0.9230769230769231
571399,GBPUSD,13,69.86,2,11,0.8461538461538461
571399,NZDUSD,3,-2.66,2,1,0.3333333333333333
571399,USDCAD,24,125.64,1,23,0.9583333333333334
571399,USDCHF,93,989.8100000000001,1,92,0.989247311827957
571399,USDJPY,83,212.95999999999998,4,79,0.9518072289156626
571399,XAUUSD,10,59.03,0,10,1.0
571521,AUDJPY,2,-2.92,1,1,0.5
571521,AUDUSD,9,-239.1,3,6,0.6666666666666666
571521,EURAUD,1,-17.05,1,0,0.0
571521,EURCAD,6,-350.46000000000004,3,3,0.5
571521,EURCHF,2,-110.63,1,1,0.5
571521,EURGBP,2,5.6899999999999995,1,1,0.5
571521,EURJPY,1,43.64,0,1,1.0
571521,EURUSD,233,-7323.34,96,137,0.5879828326180258
571521,GBPJPY,54,-720.92,21,33,0.6111111111111112
571521,GBPUSD,118,-1423.85,54,64,0.5423728813559322
571521,NZDUSD,2,-181.0,1,1,0.5
571521,USDCAD,3,-23.55,2,1,0.3333333333333333
571521,USDCHF,5,-114.11999999999999,4,1,0.2
571521,USDJPY,7,46.699999999999996,2,5,0.7142857142857143
571521,XAGUSD,110,-2794.2,60,50,0.45454545454545453
571521,XAUUSD,34,-310.15999999999997,15,19,0.5588235294117647
571678,AUDNZD,3,-3.8699999999999997,1,2,0.6666666666666666
571678,AUDUSD,1,0.04,0,1,1.0
571678,EURAUD,1,0.04,0,1,1.0
571678,EURGBP,7,12.07,1,6,0.8571428571428571
571678,EURJPY,6,-33.89,1,5,0.8333333333333334
571678,EURUSD,1101,-2786.2,107,994,0.9028156221616712
571678,GBPJPY,7,-11.18,1,6,0.8571428571428571
571678,GBPUSD,12,1.37,2,10,0.8333333333333334
571678,USDCAD,24,13.299999999999999,2,22,0.9166666666666666
571678,USDCHF,11,1.8100000000000005,3,8,0.7272727272727273
571678,USDJPY,28,20.830000000000002,2,26,0.9285714285714286
571678,XAGUSD,45,-92.8,7,38,0.8444444444444444
571678,XAUUSD,56,137.7,0,56,1.0
571758,AUDJPY,1,4.41,0,1,1.0
571758,CHFJPY,3,-39.09,3,0,0.0
571758,EURJPY,246,-6157.76,130,116,0.4715447154471545
571758,EURUSD,8,-10.559999999999999,7,1,0.125
571758,GBPJPY,119,-2034.1499999999999,72,47,0.3949579831932773
571758,GBPUSD,2,21.1,0,2,1.0
571758,USDCHF,8,-213.73000000000002,6,2,0.25
571758,USDJPY,5,50.68000000000001,2,3,0.6
571758,XAUUSD,342,-6766.46,206,136,0.39766081871345027
571791,AUDUSD,3,23.6,0,3,1.0
571791,EURCAD,1,12.64,0,1,1.0
571791,EURUSD,85,-2016.4,15,70,0.8235294117647058
571791,GBPUSD,3,29.6,0,3,1.0
571791,USDCAD,16,733.91,2,14,0.875
571791,USDCHF,5,33.8,1,4,0.8
571791,USDJPY,26,-1703.3,11,15,0.5769230769230769
571791,XAGUSD,11,817.0,3,8,0.7272727272727273
571791,XAUUSD,2,-1308.5,2,0,0.0
571830,EURUSD,118,-37.98,46,72,0.6101694915254238
572015,EURUSD,958,33.89000000000002,204,754,0.7870563674321504
572015,GBPUSD,1,-0.46,1,0,0.0
572015,USDJPY,2,-1.2,2,0,0.0
572039,AUDUSD,11,-1.9299999999999995,2,9,0.8181818181818182
572039,EURGBP,6,-9.280000000000001,3,3,0.5
572039,EURUSD,685,-1188.71,259,426,0.621897810218978
572039,GBPUSD,11,-1.8900000000000001,2,9,0.8181818181818182
572039,USDCAD,6,-0.17999999999999983,1,5,0.8333333333333334
572039,USDCHF,10,-3.21,2,8,0.8
572039,USDJPY,31,-35.15,10,21,0.6774193548387096
572177,EURUSD,176,-769.04,96,80,0.45454545454545453
572273,USDCAD,7,14.370000000000005,2,5,0.7142857142857143
572273,USDCHF,3,258.84000000000003,0,3,1.0
572273,XAGUSD,24,1258.5,2,22,0.9166666666666666
572273,XAUUSD,133,17141.65,20,113,0.849624060150376
572387,EURUSD,417,-228.25,93,324,0.7769784172661871
572387,GBPUSD,1,-0.41,1,0,0.0
572387,USDJPY,2,-1.37,2,0,0.0
572387,XAUUSD,1,-1.67,1,0,0.0
572504,EURUSD,585,-5323.1,153,432,0.7384615384615385
572563,AUDCAD,10,-46.46,7,3,0.3
572563,AUDJPY,5,11.700000000000001,2,3,0.6
572563,AUDNZD,7,1.64,2,5,0.7142857142857143
572563,AUDUSD,12,-1.3200000000000003,4,8,0.6666666666666666
572563,CADJPY,3,-58.49,2,1,0.3333333333333333
572563,EURAUD,6,15.089999999999998,1,5,0.8333333333333334
572563,EURGBP,11,-17.28,6,5,0.45454545454545453
572563,EURJPY,1,-5.32,1,0,0.0
572563,EURUSD,30,31.249999999999996,4,26,0.8666666666666667
572563,GBPJPY,4,-16.380000000000003,4,0,0.0
572563,GBPUSD,10,-37.75,5,5,0.5
572563,NZDUSD,5,-6.79,2,3,0.6
572563,USDCAD,14,-1.4699999999999995,4,10,0.7142857142857143
572563,USDCHF,19,-36.52,8,11,0.5789473684210527
572563,USDJPY,4,-3.71,1,3,0.75
572563,USDMXN,1,0.56,0,1,1.0
572563,USDTRY,1,-1.86,1,0,0.0
572616,EURUSD,172,-92.11999999999999,49,123,0.7151162790697675
572616,USDJPY,2,-0.61,2,0,0.0
572732,AUDUSD,6,-23.32,3,3,0.5
572732,EURCHF,1,6.88,0,1,1.0
572732,EURJPY,3,-59.25,2,1,0.3333333333333333
572732,EURUSD,34,-53.85,7,27,0.7941176470588235
572732,GBPUSD,3,55.5,0,3,1.0
572732,USDCAD,2,1.7399999999999993,1,1,0.5
572732,USDCHF,2,3.7800000000000002,0,2,1.0
572732,XAGUSD,18,-153.98,7,11,0.6111111111111112
572732,XAUUSD,34,150.28,8,26,0.7647058823529411
573032,AUDCAD,1,0.7,0,1,1.0
573032,AUDUSD,5,-14.53,4,1,0.2
573032,EURGBP,1,-3.84,1,0,0.0
573032,EURUSD,10,-10.61,4,6,0.6
573032,USDCHF,2,0.8900000000000001,1,1,0.5
573032,USDJPY,4,-1.8099999999999996,3,1,0.25
573032,XAGUSD,58,43.97,17,41,0.7068965517241379
573032,XAUUSD,68,195.08,28,40,0.5882352941176471
573050,XAGUSD,69,-193.8,66,3,0.043478260869565216
573050,XAUUSD,97,-2026.44,83,14,0.14432989690721648
575658,AUDJPYx,9,-1617.3400000000001,5,4,0.4444444444444444
575658,CHFJPYx,17,-2508.35,7,10,0.5882352941176471
575658,EURGBPx,87,1013.43,24,63,0.7241379310344828
575768,AUDJPYx,5,319.1,1,4,0.8
575768,AUDUSDx,9,1368.25,1,8,0.8888888888888888
575768,CADJPYx,3,259.43,0,3,1.0
575768,EURCHFx,7,-21.19999999999999,3,4,0.5714285714285714
575768,EURGBPx,6,127.96000000000001,0,6,1.0
575768,EURJPYx,9,709.75,1,8,0.8888888888888888
575768,EURUSDx,32,5561.47,2,30,0.9375
575768,GBPJPYx,5,364.15,1,4,0.8
575768,GBPUSDx,39,1822.77,0,39,1.0
575768,NZDUSDx,2,54.2,0,2,1.0
575768,USDCADx,2,52.15,0,2,1.0
575768,USDCHFx,1,40.89,0,1,1.0
575768,USDJPYx,4,133.38,0,4,1.0
576365,AUDCADx,34,-179.52,20,14,0.4117647058823529
576365,CHFJPYx,48,-271.62,19,29,0.6041666666666666
576365,EURCADx,41,-50.45000000000001,15,26,0.6341463414634146
576365,EURCHFx,47,38.519999999999996,17,30,0.6382978723404256
576365,EURGBPx,16,55.08,5,11,0.6875
576365,EURUSDx,92,-4949.3,33,59,0.6413043478260869
576365,GBPCHFx,52,-148.46,20,32,0.6153846153846154
576365,USDCADx,50,69.61,18,32,0.64
576365,USDCHFx,25,-76.83999999999999,10,15,0.6
576365,USDJPYx,6,1398.72,3,3,0.5
581103,AUDJPY,6,-1493.3,4,2,0.3333333333333333
581103,AUDUSD,8,-636.0,6,2,0.25
581103,CADJPY,6,632.3,1,5,0.8333333333333334
581103,CHFJPY,7,452.35,0,7,1.0
581103,EURAUD,11,-21.390000000000036,4,7,0.6363636363636364
581103,EURCAD,6,-109.52,4,2,0.3333333333333333
581103,EURGBP,9,454.57,5,4,0.4444444444444444
581103,EURJPY,11,628.16,1,10,0.9090909090909091
581103,EURUSD,3,242.0,1,2,0.6666666666666666
581103,GBPCHF,5,-265.4,3,2,0.4
581103,GBPUSD,31,1421.0,13,18,0.5806451612903226
581103,NZDUSD,8,422.0,2,6,0.75
581103,USDCAD,7,105.24,3,4,0.5714285714285714
581103,USDCHF,3,31.539999999999992,2,1,0.3333333333333333
581103,USDJPY,2,-40.37,2,0,0.0
581729,AUDCAD,1,-45.27,1,0,0.0
581729,AUDUSD,10,516.5,1,9,0.9
581729,CHFJPY,1,-18.1,1,0,0.0
581729,EURGBP,13,-139.20000000000002,8,5,0.38461538461538464
581729,EURJPY,25,297.67,10,15,0.6
581729,EURUSD,21,-4621.2,9,12,0.5714285714285714
581729,GBPJPY,5,-21.330000000000002,2,3,0.6
581729,GBPUSD,13,-507.3,5,8,0.6153846153846154
581729,NZDUSD,2,20.0,0,2,1.0
581729,USDCAD,8,-1304.08,4,4,0.5
581729,USDCHF,5,47.93,1,4,0.8
581729,USDJPY,18,-461.59,11,7,0.3888888888888889
601622,AUDCAD,2,-1.94,2,0,0.0
601622,AUDJPY,11,-22.599999999999998,3,8,0.7272727272727273
601622,AUDUSD,23,37.75,5,18,0.782608695652174
601622,CADJPY,6,3.780000000000001,4,2,0.3333333333333333
601622,CHFJPY,14,4.860000000000003,2,12,0.8571428571428571
601622,EURAUD,1,-0.68,1,0,0.0
601622,EURCAD,11,7.869999999999999,2,9,0.8181818181818182
601622,EURCHF,2,-28.07,2,0,0.0
601622,EURGBP,15,31.55,5,10,0.6666666666666666
601622,EURJPY,313,-968.49,124,189,0.6038338658146964
601622,EURUSD,292,-230.95,97,195,0.6678082191780822
601622,GBPCHF,10,-34.81,5,5,0.5
601622,GBPJPY,28,-24.44,10,18,0.6428571428571429
601622,GBPUSD,206,-312.21999999999997,81,125,0.6067961165048543
601622,NZDUSD,13,-13.499999999999998,3,10,0.7692307692307693
601622,USDCAD,29,-23.17,16,13,0.4482758620689655
601622,USDCHF,49,-289.95,17,32,0.6530612244897959
601622,USDJPY,54,99.22,10,44,0.8148148148148148
601622,XAGUSD,4,-0.5000000000000001,2,2,0.5
601622,XAUUSD,22,121.03999999999999,3,19,0.8636363636363636
606958,EURJPY,197,-9388.12,66,131,0.6649746192893401
606958,EURUSD,7,41.199999999999996,4,3,0.42857142857142855
6866968,AUDCAD,1,-5.62,1,0,0.0
6866968,AUDJPY,25,-76.41000000000001,15,10,0.4
6866968,AUDUSD,45,990.5,14,31,0.6888888888888889
6866968,CADJPY,3,0.33999999999999986,2,1,0.3333333333333333
6866968,CHFJPY,6,-19.98,3,3,0.5
6866968,EURGBP,2,-13.86,1,1,0.5
6866968,EURJPY,115,-95.11999999999999,59,56,0.48695652173913045
6866968,EURUSD,39,-112.5,26,13,0.3333333333333333
6866968,GBPJPY,80,-363.5,50,30,0.375
6866968,GBPUSD,32,79.3,14,18,0.5625
6866968,NZDUSD,3,-8.6,3,0,0.0
6866968,USDCAD,6,-15.980000000000002,4,2,0.3333333333333333
6866968,USDCHF,4,-2.51,2,2,0.5
6866968,USDJPY,31,-114.67,18,13,0.41935483870967744
6866968,XAUUSD,3,-254.57,3,0,0.0
